InventoryId,ScheduleId,FlightNumber,AircraftType,DepartureDate,ArrivalDate,DepartureAirport,ArrivalAirport,TotalCapacity,TotalInventory,BookedInventory,Oversold,AvailableInventory,FirstClass,BusinessClass,PremiumEconomyClass,EconomyClass,FC_TotalInventory,FC_BookedInventory,FC_AvailableInventory,BC_TotalInventory,BC_BookedInventory,BC_AvailableInventory,PC_TotalInventory,PC_BookedInventory,PC_AvailableInventory,EC_TotalInventory,EC_BookedInventory,EC_AvailableInventory,FC_CD,BC_CD,PC_CD,EC_CD
INV-ZZ-0000001,SCH-ZZ-0000001,1001,Boeing 787,08/19/2024,08/19/2024,MAA,BLR,270,291,187,-83,104,27,54,81,108,29,20,9,60,45,15,85,78,7,117,44,73,"{'F': 16, 'P': 11}","{'C': 22, 'J': 16, 'Z': 16}","{'Q': 24, 'R': 16, 'S': 8, 'T': 8, 'H': 16, 'M': 8}","{'Y': 8, 'A': 8, 'B': 4, 'D': 4, 'E': 4, 'G': 8, 'I': 4, 'K': 8, 'L': 4, 'N': 4, 'O': 4, 'U': 8, 'V': 4, 'W': 4, 'X': 4}"
INV-ZZ-0000065,SCH-ZZ-0000065,1001,Boeing 787,08/19/2024,08/19/2024,MAA,BLR,270,291,196,-74,95,27,54,81,108,32,22,10,55,43,12,82,55,27,122,76,46,"{'F': 16, 'P': 11}","{'C': 22, 'J': 16, 'Z': 16}","{'Q': 24, 'R': 16, 'S': 8, 'T': 8, 'H': 16, 'M': 8}","{'Y': 8, 'A': 8, 'B': 4, 'D': 4, 'E': 4, 'G': 8, 'I': 4, 'K': 8, 'L': 4, 'N': 4, 'O': 4, 'U': 8, 'V': 4, 'W': 4, 'X': 4}"
INV-ZZ-0000129,SCH-ZZ-0000129,1001,Boeing 787,08/19/2024,08/19/2024,MAA,BLR,270,296,179,-91,117,27,54,81,108,30,18,12,59,22,37,91,51,40,116,88,28,"{'F': 16, 'P': 11}","{'C': 22, 'J': 16, 'Z': 16}","{'Q': 24, 'R': 16, 'S': 8, 'T': 8, 'H': 16, 'M': 8}","{'Y': 8, 'A': 8, 'B': 4, 'D': 4, 'E': 4, 'G': 8, 'I': 4, 'K': 8, 'L': 4, 'N': 4, 'O': 4, 'U': 8, 'V': 4, 'W': 4, 'X': 4}"
INV-ZZ-0000002,SCH-ZZ-0000002,1002,Boeing 787,08/19/2024,08/19/2024,MAA,BOM,270,292,188,-82,104,27,54,81,108,30,15,15,57,29,28,90,78,12,115,66,49,"{'F': 16, 'P': 11}","{'C': 22, 'J': 16, 'Z': 16}","{'Q': 24, 'R': 16, 'S': 8, 'T': 8, 'H': 16, 'M': 8}","{'Y': 8, 'A': 8, 'B': 4, 'D': 4, 'E': 4, 'G': 8, 'I': 4, 'K': 8, 'L': 4, 'N': 4, 'O': 4, 'U': 8, 'V': 4, 'W': 4, 'X': 4}"
INV-ZZ-0000066,SCH-ZZ-0000066,1002,Boeing 787,08/19/2024,08/19/2024,MAA,BOM,270,283,215,-55,68,27,54,81,108,29,11,18,60,50,10,85,70,15,109,84,25,"{'F': 16, 'P': 11}","{'C': 22, 'J': 16, 'Z': 16}","{'Q': 24, 'R': 16, 'S': 8, 'T': 8, 'H': 16, 'M': 8}","{'Y': 8, 'A': 8, 'B': 4, 'D': 4, 'E': 4, 'G': 8, 'I': 4, 'K': 8, 'L': 4, 'N': 4, 'O': 4, 'U': 8, 'V': 4, 'W': 4, 'X': 4}"
INV-ZZ-0000130,SCH-ZZ-0000130,1002,Boeing 787,08/19/2024,08/19/2024,MAA,BOM,270,292,138,-132,154,27,54,81,108,32,10,22,55,23,32,90,53,37,115,52,63,"{'F': 16, 'P': 11}","{'C': 22, 'J': 16, 'Z': 16}","{'Q': 24, 'R': 16, 'S': 8, 'T': 8, 'H': 16, 'M': 8}","{'Y': 8, 'A': 8, 'B': 4, 'D': 4, 'E': 4, 'G': 8, 'I': 4, 'K': 8, 'L': 4, 'N': 4, 'O': 4, 'U': 8, 'V': 4, 'W': 4, 'X': 4}"
INV-ZZ-0000003,SCH-ZZ-0000003,1003,Boeing 787,08/19/2024,08/19/2024,MAA,DUB,270,291,169,-101,122,27,54,81,108,29,20,9,58,25,33,91,73,18,113,51,62,"{'F': 16, 'P': 11}","{'C': 22, 'J': 16, 'Z': 16}","{'Q': 24, 'R': 16, 'S': 8, 'T': 8, 'H': 16, 'M': 8}","{'Y': 8, 'A': 8, 'B': 4, 'D': 4, 'E': 4, 'G': 8, 'I': 4, 'K': 8, 'L': 4, 'N': 4, 'O': 4, 'U': 8, 'V': 4, 'W': 4, 'X': 4}"
INV-ZZ-0000067,SCH-ZZ-0000067,1003,Boeing 787,08/19/2024,08/19/2024,MAA,DUB,270,296,181,-89,115,27,54,81,108,32,13,19,55,49,6,82,54,28,127,65,62,"{'F': 16, 'P': 11}","{'C': 22, 'J': 16, 'Z': 16}","{'Q': 24, 'R': 16, 'S': 8, 'T': 8, 'H': 16, 'M': 8}","{'Y': 8, 'A': 8, 'B': 4, 'D': 4, 'E': 4, 'G': 8, 'I': 4, 'K': 8, 'L': 4, 'N': 4, 'O': 4, 'U': 8, 'V': 4, 'W': 4, 'X': 4}"
INV-ZZ-0000131,SCH-ZZ-0000131,1003,Boeing 787,08/19/2024,08/19/2024,MAA,DUB,270,302,160,-110,142,27,54,81,108,28,11,17,56,20,36,91,59,32,127,70,57,"{'F': 16, 'P': 11}","{'C': 22, 'J': 16, 'Z': 16}","{'Q': 24, 'R': 16, 'S': 8, 'T': 8, 'H': 16, 'M': 8}","{'Y': 8, 'A': 8, 'B': 4, 'D': 4, 'E': 4, 'G': 8, 'I': 4, 'K': 8, 'L': 4, 'N': 4, 'O': 4, 'U': 8, 'V': 4, 'W': 4, 'X': 4}"
INV-ZZ-0000004,SCH-ZZ-0000004,1004,Boeing 787,08/19/2024,08/19/2024,MAA,VNS,270,291,203,-67,88,27,54,81,108,28,19,9,56,36,20,87,80,7,120,68,52,"{'F': 16, 'P': 11}","{'C': 22, 'J': 16, 'Z': 16}","{'Q': 24, 'R': 16, 'S': 8, 'T': 8, 'H': 16, 'M': 8}","{'Y': 8, 'A': 8, 'B': 4, 'D': 4, 'E': 4, 'G': 8, 'I': 4, 'K': 8, 'L': 4, 'N': 4, 'O': 4, 'U': 8, 'V': 4, 'W': 4, 'X': 4}"
INV-ZZ-0000068,SCH-ZZ-0000068,1004,Boeing 787,08/19/2024,08/19/2024,MAA,VNS,270,294,161,-109,133,27,54,81,108,31,14,17,56,21,35,84,60,24,123,66,57,"{'F': 16, 'P': 11}","{'C': 22, 'J': 16, 'Z': 16}","{'Q': 24, 'R': 16, 'S': 8, 'T': 8, 'H': 16, 'M': 8}","{'Y': 8, 'A': 8, 'B': 4, 'D': 4, 'E': 4, 'G': 8, 'I': 4, 'K': 8, 'L': 4, 'N': 4, 'O': 4, 'U': 8, 'V': 4, 'W': 4, 'X': 4}"
INV-ZZ-0000132,SCH-ZZ-0000132,1004,Boeing 787,08/19/2024,08/19/2024,MAA,VNS,270,283,186,-84,97,27,54,81,108,30,27,3,58,22,36,84,80,4,111,57,54,"{'F': 16, 'P': 11}","{'C': 22, 'J': 16, 'Z': 16}","{'Q': 24, 'R': 16, 'S': 8, 'T': 8, 'H': 16, 'M': 8}","{'Y': 8, 'A': 8, 'B': 4, 'D': 4, 'E': 4, 'G': 8, 'I': 4, 'K': 8, 'L': 4, 'N': 4, 'O': 4, 'U': 8, 'V': 4, 'W': 4, 'X': 4}"
INV-ZZ-0000005,SCH-ZZ-0000005,1005,Boeing 787,08/19/2024,08/19/2024,MAA,JFK,270,291,175,-95,116,27,54,81,108,30,23,7,58,43,15,87,38,49,116,71,45,"{'F': 16, 'P': 11}","{'C': 22, 'J': 16, 'Z': 16}","{'Q': 24, 'R': 16, 'S': 8, 'T': 8, 'H': 16, 'M': 8}","{'Y': 8, 'A': 8, 'B': 4, 'D': 4, 'E': 4, 'G': 8, 'I': 4, 'K': 8, 'L': 4, 'N': 4, 'O': 4, 'U': 8, 'V': 4, 'W': 4, 'X': 4}"
INV-ZZ-0000069,SCH-ZZ-0000069,1005,Boeing 787,08/19/2024,08/19/2024,MAA,JFK,270,294,208,-62,86,27,54,81,108,31,25,6,59,32,27,83,58,25,121,93,28,"{'F': 16, 'P': 11}","{'C': 22, 'J': 16, 'Z': 16}","{'Q': 24, 'R': 16, 'S': 8, 'T': 8, 'H': 16, 'M': 8}","{'Y': 8, 'A': 8, 'B': 4, 'D': 4, 'E': 4, 'G': 8, 'I': 4, 'K': 8, 'L': 4, 'N': 4, 'O': 4, 'U': 8, 'V': 4, 'W': 4, 'X': 4}"
INV-ZZ-0000133,SCH-ZZ-0000133,1005,Boeing 787,08/19/2024,08/19/2024,MAA,JFK,270,295,234,-36,61,27,54,81,108,30,19,11,60,47,13,86,81,5,119,87,32,"{'F': 16, 'P': 11}","{'C': 22, 'J': 16, 'Z': 16}","{'Q': 24, 'R': 16, 'S': 8, 'T': 8, 'H': 16, 'M': 8}","{'Y': 8, 'A': 8, 'B': 4, 'D': 4, 'E': 4, 'G': 8, 'I': 4, 'K': 8, 'L': 4, 'N': 4, 'O': 4, 'U': 8, 'V': 4, 'W': 4, 'X': 4}"
INV-ZZ-0000006,SCH-ZZ-0000006,1006,Boeing 787,08/19/2024,08/19/2024,MAA,DEL,270,281,219,-51,62,27,54,81,108,31,17,14,56,45,11,85,76,9,109,81,28,"{'F': 16, 'P': 11}","{'C': 22, 'J': 16, 'Z': 16}","{'Q': 24, 'R': 16, 'S': 8, 'T': 8, 'H': 16, 'M': 8}","{'Y': 8, 'A': 8, 'B': 4, 'D': 4, 'E': 4, 'G': 8, 'I': 4, 'K': 8, 'L': 4, 'N': 4, 'O': 4, 'U': 8, 'V': 4, 'W': 4, 'X': 4}"
INV-ZZ-0000070,SCH-ZZ-0000070,1006,Boeing 787,08/19/2024,08/19/2024,MAA,DEL,270,294,214,-56,80,27,54,81,108,32,26,6,57,29,28,87,61,26,118,98,20,"{'F': 16, 'P': 11}","{'C': 22, 'J': 16, 'Z': 16}","{'Q': 24, 'R': 16, 'S': 8, 'T': 8, 'H': 16, 'M': 8}","{'Y': 8, 'A': 8, 'B': 4, 'D': 4, 'E': 4, 'G': 8, 'I': 4, 'K': 8, 'L': 4, 'N': 4, 'O': 4, 'U': 8, 'V': 4, 'W': 4, 'X': 4}"
INV-ZZ-0000134,SCH-ZZ-0000134,1006,Boeing 787,08/19/2024,08/19/2024,MAA,DEL,270,292,237,-33,55,27,54,81,108,30,19,11,61,45,16,90,70,20,111,103,8,"{'F': 16, 'P': 11}","{'C': 22, 'J': 16, 'Z': 16}","{'Q': 24, 'R': 16, 'S': 8, 'T': 8, 'H': 16, 'M': 8}","{'Y': 8, 'A': 8, 'B': 4, 'D': 4, 'E': 4, 'G': 8, 'I': 4, 'K': 8, 'L': 4, 'N': 4, 'O': 4, 'U': 8, 'V': 4, 'W': 4, 'X': 4}"
INV-ZZ-0000007,SCH-ZZ-0000007,1007,Boeing 787,08/19/2024,08/19/2024,MAA,LAX,270,282,195,-75,87,27,54,81,108,31,20,11,58,34,24,84,73,11,109,68,41,"{'F': 16, 'P': 11}","{'C': 22, 'J': 16, 'Z': 16}","{'Q': 24, 'R': 16, 'S': 8, 'T': 8, 'H': 16, 'M': 8}","{'Y': 8, 'A': 8, 'B': 4, 'D': 4, 'E': 4, 'G': 8, 'I': 4, 'K': 8, 'L': 4, 'N': 4, 'O': 4, 'U': 8, 'V': 4, 'W': 4, 'X': 4}"
INV-ZZ-0000071,SCH-ZZ-0000071,1007,Boeing 787,08/19/2024,08/19/2024,MAA,LAX,270,286,183,-87,103,27,54,81,108,31,13,18,60,51,9,82,70,12,113,49,64,"{'F': 16, 'P': 11}","{'C': 22, 'J': 16, 'Z': 16}","{'Q': 24, 'R': 16, 'S': 8, 'T': 8, 'H': 16, 'M': 8}","{'Y': 8, 'A': 8, 'B': 4, 'D': 4, 'E': 4, 'G': 8, 'I': 4, 'K': 8, 'L': 4, 'N': 4, 'O': 4, 'U': 8, 'V': 4, 'W': 4, 'X': 4}"
INV-ZZ-0000135,SCH-ZZ-0000135,1007,Boeing 787,08/19/2024,08/19/2024,MAA,LAX,270,306,195,-75,111,27,54,81,108,32,16,16,57,35,22,90,51,39,127,93,34,"{'F': 16, 'P': 11}","{'C': 22, 'J': 16, 'Z': 16}","{'Q': 24, 'R': 16, 'S': 8, 'T': 8, 'H': 16, 'M': 8}","{'Y': 8, 'A': 8, 'B': 4, 'D': 4, 'E': 4, 'G': 8, 'I': 4, 'K': 8, 'L': 4, 'N': 4, 'O': 4, 'U': 8, 'V': 4, 'W': 4, 'X': 4}"
INV-ZZ-0000008,SCH-ZZ-0000008,1008,Boeing 787,08/19/2024,08/19/2024,BLR,MAA,270,286,189,-81,97,27,54,81,108,29,21,8,55,52,3,82,51,31,120,65,55,"{'F': 16, 'P': 11}","{'C': 22, 'J': 16, 'Z': 16}","{'Q': 24, 'R': 16, 'S': 8, 'T': 8, 'H': 16, 'M': 8}","{'Y': 8, 'A': 8, 'B': 4, 'D': 4, 'E': 4, 'G': 8, 'I': 4, 'K': 8, 'L': 4, 'N': 4, 'O': 4, 'U': 8, 'V': 4, 'W': 4, 'X': 4}"
INV-ZZ-0000072,SCH-ZZ-0000072,1008,Boeing 787,08/19/2024,08/19/2024,BLR,MAA,270,301,203,-67,98,27,54,81,108,30,21,9,59,29,30,91,75,16,121,78,43,"{'F': 16, 'P': 11}","{'C': 22, 'J': 16, 'Z': 16}","{'Q': 24, 'R': 16, 'S': 8, 'T': 8, 'H': 16, 'M': 8}","{'Y': 8, 'A': 8, 'B': 4, 'D': 4, 'E': 4, 'G': 8, 'I': 4, 'K': 8, 'L': 4, 'N': 4, 'O': 4, 'U': 8, 'V': 4, 'W': 4, 'X': 4}"
INV-ZZ-0000136,SCH-ZZ-0000136,1008,Boeing 787,08/19/2024,08/19/2024,BLR,MAA,270,293,168,-102,125,27,54,81,108,30,21,9,61,27,34,87,49,38,115,71,44,"{'F': 16, 'P': 11}","{'C': 22, 'J': 16, 'Z': 16}","{'Q': 24, 'R': 16, 'S': 8, 'T': 8, 'H': 16, 'M': 8}","{'Y': 8, 'A': 8, 'B': 4, 'D': 4, 'E': 4, 'G': 8, 'I': 4, 'K': 8, 'L': 4, 'N': 4, 'O': 4, 'U': 8, 'V': 4, 'W': 4, 'X': 4}"
INV-ZZ-0000010,SCH-ZZ-0000010,1010,Boeing 787,08/19/2024,08/19/2024,BLR,BOM,270,294,180,-90,114,27,54,81,108,29,20,9,55,20,35,89,78,11,121,62,59,"{'F': 16, 'P': 11}","{'C': 22, 'J': 16, 'Z': 16}","{'Q': 24, 'R': 16, 'S': 8, 'T': 8, 'H': 16, 'M': 8}","{'Y': 8, 'A': 8, 'B': 4, 'D': 4, 'E': 4, 'G': 8, 'I': 4, 'K': 8, 'L': 4, 'N': 4, 'O': 4, 'U': 8, 'V': 4, 'W': 4, 'X': 4}"
INV-ZZ-0000074,SCH-ZZ-0000074,1010,Boeing 787,08/19/2024,08/19/2024,BLR,BOM,270,293,173,-97,120,27,54,81,108,29,13,16,57,46,11,82,68,14,125,46,79,"{'F': 16, 'P': 11}","{'C': 22, 'J': 16, 'Z': 16}","{'Q': 24, 'R': 16, 'S': 8, 'T': 8, 'H': 16, 'M': 8}","{'Y': 8, 'A': 8, 'B': 4, 'D': 4, 'E': 4, 'G': 8, 'I': 4, 'K': 8, 'L': 4, 'N': 4, 'O': 4, 'U': 8, 'V': 4, 'W': 4, 'X': 4}"
INV-ZZ-0000138,SCH-ZZ-0000138,1010,Boeing 787,08/19/2024,08/19/2024,BLR,BOM,270,304,170,-100,134,27,54,81,108,32,25,7,59,24,35,85,56,29,128,65,63,"{'F': 16, 'P': 11}","{'C': 22, 'J': 16, 'Z': 16}","{'Q': 24, 'R': 16, 'S': 8, 'T': 8, 'H': 16, 'M': 8}","{'Y': 8, 'A': 8, 'B': 4, 'D': 4, 'E': 4, 'G': 8, 'I': 4, 'K': 8, 'L': 4, 'N': 4, 'O': 4, 'U': 8, 'V': 4, 'W': 4, 'X': 4}"
INV-ZZ-0000011,SCH-ZZ-0000011,1011,Boeing 787,08/19/2024,08/19/2024,BLR,DUB,270,297,152,-118,145,27,54,81,108,30,22,8,57,47,10,88,40,48,122,43,79,"{'F': 16, 'P': 11}","{'C': 22, 'J': 16, 'Z': 16}","{'Q': 24, 'R': 16, 'S': 8, 'T': 8, 'H': 16, 'M': 8}","{'Y': 8, 'A': 8, 'B': 4, 'D': 4, 'E': 4, 'G': 8, 'I': 4, 'K': 8, 'L': 4, 'N': 4, 'O': 4, 'U': 8, 'V': 4, 'W': 4, 'X': 4}"
INV-ZZ-0000075,SCH-ZZ-0000075,1011,Boeing 787,08/19/2024,08/19/2024,BLR,DUB,270,291,192,-78,99,27,54,81,108,31,22,9,57,44,13,88,66,22,115,60,55,"{'F': 16, 'P': 11}","{'C': 22, 'J': 16, 'Z': 16}","{'Q': 24, 'R': 16, 'S': 8, 'T': 8, 'H': 16, 'M': 8}","{'Y': 8, 'A': 8, 'B': 4, 'D': 4, 'E': 4, 'G': 8, 'I': 4, 'K': 8, 'L': 4, 'N': 4, 'O': 4, 'U': 8, 'V': 4, 'W': 4, 'X': 4}"
INV-ZZ-0000139,SCH-ZZ-0000139,1011,Boeing 787,08/19/2024,08/19/2024,BLR,DUB,270,288,154,-116,134,27,54,81,108,31,12,19,57,34,23,86,63,23,114,45,69,"{'F': 16, 'P': 11}","{'C': 22, 'J': 16, 'Z': 16}","{'Q': 24, 'R': 16, 'S': 8, 'T': 8, 'H': 16, 'M': 8}","{'Y': 8, 'A': 8, 'B': 4, 'D': 4, 'E': 4, 'G': 8, 'I': 4, 'K': 8, 'L': 4, 'N': 4, 'O': 4, 'U': 8, 'V': 4, 'W': 4, 'X': 4}"
INV-ZZ-0000012,SCH-ZZ-0000012,1012,Boeing 787,08/19/2024,08/19/2024,BLR,VNS,270,285,174,-96,111,27,54,81,108,30,13,17,59,45,14,87,44,43,109,72,37,"{'F': 16, 'P': 11}","{'C': 22, 'J': 16, 'Z': 16}","{'Q': 24, 'R': 16, 'S': 8, 'T': 8, 'H': 16, 'M': 8}","{'Y': 8, 'A': 8, 'B': 4, 'D': 4, 'E': 4, 'G': 8, 'I': 4, 'K': 8, 'L': 4, 'N': 4, 'O': 4, 'U': 8, 'V': 4, 'W': 4, 'X': 4}"
INV-ZZ-0000076,SCH-ZZ-0000076,1012,Boeing 787,08/19/2024,08/19/2024,BLR,VNS,270,302,234,-36,68,27,54,81,108,31,13,18,60,47,13,83,79,4,128,95,33,"{'F': 16, 'P': 11}","{'C': 22, 'J': 16, 'Z': 16}","{'Q': 24, 'R': 16, 'S': 8, 'T': 8, 'H': 16, 'M': 8}","{'Y': 8, 'A': 8, 'B': 4, 'D': 4, 'E': 4, 'G': 8, 'I': 4, 'K': 8, 'L': 4, 'N': 4, 'O': 4, 'U': 8, 'V': 4, 'W': 4, 'X': 4}"
INV-ZZ-0000140,SCH-ZZ-0000140,1012,Boeing 787,08/19/2024,08/19/2024,BLR,VNS,270,298,177,-93,121,27,54,81,108,30,19,11,55,29,26,90,61,29,123,68,55,"{'F': 16, 'P': 11}","{'C': 22, 'J': 16, 'Z': 16}","{'Q': 24, 'R': 16, 'S': 8, 'T': 8, 'H': 16, 'M': 8}","{'Y': 8, 'A': 8, 'B': 4, 'D': 4, 'E': 4, 'G': 8, 'I': 4, 'K': 8, 'L': 4, 'N': 4, 'O': 4, 'U': 8, 'V': 4, 'W': 4, 'X': 4}"
INV-ZZ-0000013,SCH-ZZ-0000013,1013,Boeing 787,08/19/2024,08/19/2024,BLR,JFK,270,292,205,-65,87,27,54,81,108,31,26,5,59,41,18,86,61,25,116,77,39,"{'F': 16, 'P': 11}","{'C': 22, 'J': 16, 'Z': 16}","{'Q': 24, 'R': 16, 'S': 8, 'T': 8, 'H': 16, 'M': 8}","{'Y': 8, 'A': 8, 'B': 4, 'D': 4, 'E': 4, 'G': 8, 'I': 4, 'K': 8, 'L': 4, 'N': 4, 'O': 4, 'U': 8, 'V': 4, 'W': 4, 'X': 4}"
INV-ZZ-0000077,SCH-ZZ-0000077,1013,Boeing 787,08/19/2024,08/19/2024,BLR,JFK,270,289,182,-88,107,27,54,81,108,31,22,9,55,37,18,87,48,39,116,75,41,"{'F': 16, 'P': 11}","{'C': 22, 'J': 16, 'Z': 16}","{'Q': 24, 'R': 16, 'S': 8, 'T': 8, 'H': 16, 'M': 8}","{'Y': 8, 'A': 8, 'B': 4, 'D': 4, 'E': 4, 'G': 8, 'I': 4, 'K': 8, 'L': 4, 'N': 4, 'O': 4, 'U': 8, 'V': 4, 'W': 4, 'X': 4}"
INV-ZZ-0000141,SCH-ZZ-0000141,1013,Boeing 787,08/19/2024,08/19/2024,BLR,JFK,270,297,187,-83,110,27,54,81,108,29,13,16,58,26,32,83,57,26,127,91,36,"{'F': 16, 'P': 11}","{'C': 22, 'J': 16, 'Z': 16}","{'Q': 24, 'R': 16, 'S': 8, 'T': 8, 'H': 16, 'M': 8}","{'Y': 8, 'A': 8, 'B': 4, 'D': 4, 'E': 4, 'G': 8, 'I': 4, 'K': 8, 'L': 4, 'N': 4, 'O': 4, 'U': 8, 'V': 4, 'W': 4, 'X': 4}"
INV-ZZ-0000014,SCH-ZZ-0000014,1014,Boeing 787,08/19/2024,08/19/2024,BLR,DEL,270,298,169,-101,129,27,54,81,108,30,14,16,59,48,11,83,45,38,126,62,64,"{'F': 16, 'P': 11}","{'C': 22, 'J': 16, 'Z': 16}","{'Q': 24, 'R': 16, 'S': 8, 'T': 8, 'H': 16, 'M': 8}","{'Y': 8, 'A': 8, 'B': 4, 'D': 4, 'E': 4, 'G': 8, 'I': 4, 'K': 8, 'L': 4, 'N': 4, 'O': 4, 'U': 8, 'V': 4, 'W': 4, 'X': 4}"
INV-ZZ-0000078,SCH-ZZ-0000078,1014,Boeing 787,08/19/2024,08/19/2024,BLR,DEL,270,299,171,-99,128,27,54,81,108,30,25,5,59,35,24,86,46,40,124,65,59,"{'F': 16, 'P': 11}","{'C': 22, 'J': 16, 'Z': 16}","{'Q': 24, 'R': 16, 'S': 8, 'T': 8, 'H': 16, 'M': 8}","{'Y': 8, 'A': 8, 'B': 4, 'D': 4, 'E': 4, 'G': 8, 'I': 4, 'K': 8, 'L': 4, 'N': 4, 'O': 4, 'U': 8, 'V': 4, 'W': 4, 'X': 4}"
INV-ZZ-0000142,SCH-ZZ-0000142,1014,Boeing 787,08/19/2024,08/19/2024,BLR,DEL,270,289,203,-67,86,27,54,81,108,32,25,7,61,38,23,84,75,9,112,65,47,"{'F': 16, 'P': 11}","{'C': 22, 'J': 16, 'Z': 16}","{'Q': 24, 'R': 16, 'S': 8, 'T': 8, 'H': 16, 'M': 8}","{'Y': 8, 'A': 8, 'B': 4, 'D': 4, 'E': 4, 'G': 8, 'I': 4, 'K': 8, 'L': 4, 'N': 4, 'O': 4, 'U': 8, 'V': 4, 'W': 4, 'X': 4}"
INV-ZZ-0000015,SCH-ZZ-0000015,1015,Boeing 787,08/19/2024,08/19/2024,BLR,LAX,270,287,221,-49,66,27,54,81,108,31,10,21,55,49,6,89,75,14,112,87,25,"{'F': 16, 'P': 11}","{'C': 22, 'J': 16, 'Z': 16}","{'Q': 24, 'R': 16, 'S': 8, 'T': 8, 'H': 16, 'M': 8}","{'Y': 8, 'A': 8, 'B': 4, 'D': 4, 'E': 4, 'G': 8, 'I': 4, 'K': 8, 'L': 4, 'N': 4, 'O': 4, 'U': 8, 'V': 4, 'W': 4, 'X': 4}"
INV-ZZ-0000079,SCH-ZZ-0000079,1015,Boeing 787,08/19/2024,08/19/2024,BLR,LAX,270,300,218,-52,82,27,54,81,108,31,25,6,60,47,13,91,73,18,118,73,45,"{'F': 16, 'P': 11}","{'C': 22, 'J': 16, 'Z': 16}","{'Q': 24, 'R': 16, 'S': 8, 'T': 8, 'H': 16, 'M': 8}","{'Y': 8, 'A': 8, 'B': 4, 'D': 4, 'E': 4, 'G': 8, 'I': 4, 'K': 8, 'L': 4, 'N': 4, 'O': 4, 'U': 8, 'V': 4, 'W': 4, 'X': 4}"
INV-ZZ-0000143,SCH-ZZ-0000143,1015,Boeing 787,08/19/2024,08/19/2024,BLR,LAX,270,280,192,-78,88,27,54,81,108,29,21,8,57,41,16,85,48,37,109,82,27,"{'F': 16, 'P': 11}","{'C': 22, 'J': 16, 'Z': 16}","{'Q': 24, 'R': 16, 'S': 8, 'T': 8, 'H': 16, 'M': 8}","{'Y': 8, 'A': 8, 'B': 4, 'D': 4, 'E': 4, 'G': 8, 'I': 4, 'K': 8, 'L': 4, 'N': 4, 'O': 4, 'U': 8, 'V': 4, 'W': 4, 'X': 4}"
INV-ZZ-0000016,SCH-ZZ-0000016,1016,Boeing 787,08/19/2024,08/19/2024,BOM,MAA,270,304,179,-91,125,27,54,81,108,31,14,17,56,54,2,89,51,38,128,60,68,"{'F': 16, 'P': 11}","{'C': 22, 'J': 16, 'Z': 16}","{'Q': 24, 'R': 16, 'S': 8, 'T': 8, 'H': 16, 'M': 8}","{'Y': 8, 'A': 8, 'B': 4, 'D': 4, 'E': 4, 'G': 8, 'I': 4, 'K': 8, 'L': 4, 'N': 4, 'O': 4, 'U': 8, 'V': 4, 'W': 4, 'X': 4}"
INV-ZZ-0000080,SCH-ZZ-0000080,1016,Boeing 787,08/19/2024,08/19/2024,BOM,MAA,270,284,194,-76,90,27,54,81,108,32,21,11,56,52,4,87,77,10,109,44,65,"{'F': 16, 'P': 11}","{'C': 22, 'J': 16, 'Z': 16}","{'Q': 24, 'R': 16, 'S': 8, 'T': 8, 'H': 16, 'M': 8}","{'Y': 8, 'A': 8, 'B': 4, 'D': 4, 'E': 4, 'G': 8, 'I': 4, 'K': 8, 'L': 4, 'N': 4, 'O': 4, 'U': 8, 'V': 4, 'W': 4, 'X': 4}"
INV-ZZ-0000144,SCH-ZZ-0000144,1016,Boeing 787,08/19/2024,08/19/2024,BOM,MAA,270,277,113,-157,164,27,54,81,108,30,17,13,55,20,35,83,36,47,109,40,69,"{'F': 16, 'P': 11}","{'C': 22, 'J': 16, 'Z': 16}","{'Q': 24, 'R': 16, 'S': 8, 'T': 8, 'H': 16, 'M': 8}","{'Y': 8, 'A': 8, 'B': 4, 'D': 4, 'E': 4, 'G': 8, 'I': 4, 'K': 8, 'L': 4, 'N': 4, 'O': 4, 'U': 8, 'V': 4, 'W': 4, 'X': 4}"
INV-ZZ-0000017,SCH-ZZ-0000017,1017,Boeing 787,08/19/2024,08/19/2024,BOM,BLR,270,299,199,-71,100,27,54,81,108,29,27,2,57,37,20,85,41,44,128,94,34,"{'F': 16, 'P': 11}","{'C': 22, 'J': 16, 'Z': 16}","{'Q': 24, 'R': 16, 'S': 8, 'T': 8, 'H': 16, 'M': 8}","{'Y': 8, 'A': 8, 'B': 4, 'D': 4, 'E': 4, 'G': 8, 'I': 4, 'K': 8, 'L': 4, 'N': 4, 'O': 4, 'U': 8, 'V': 4, 'W': 4, 'X': 4}"
INV-ZZ-0000081,SCH-ZZ-0000081,1017,Boeing 787,08/19/2024,08/19/2024,BOM,BLR,270,284,198,-72,86,27,54,81,108,31,20,11,59,28,31,85,81,4,109,69,40,"{'F': 16, 'P': 11}","{'C': 22, 'J': 16, 'Z': 16}","{'Q': 24, 'R': 16, 'S': 8, 'T': 8, 'H': 16, 'M': 8}","{'Y': 8, 'A': 8, 'B': 4, 'D': 4, 'E': 4, 'G': 8, 'I': 4, 'K': 8, 'L': 4, 'N': 4, 'O': 4, 'U': 8, 'V': 4, 'W': 4, 'X': 4}"
INV-ZZ-0000145,SCH-ZZ-0000145,1017,Boeing 787,08/19/2024,08/19/2024,BOM,BLR,270,285,190,-80,95,27,54,81,108,30,26,4,59,49,10,86,35,51,110,80,30,"{'F': 16, 'P': 11}","{'C': 22, 'J': 16, 'Z': 16}","{'Q': 24, 'R': 16, 'S': 8, 'T': 8, 'H': 16, 'M': 8}","{'Y': 8, 'A': 8, 'B': 4, 'D': 4, 'E': 4, 'G': 8, 'I': 4, 'K': 8, 'L': 4, 'N': 4, 'O': 4, 'U': 8, 'V': 4, 'W': 4, 'X': 4}"
INV-ZZ-0000019,SCH-ZZ-0000019,1019,Boeing 787,08/19/2024,08/19/2024,BOM,DUB,270,291,191,-79,100,27,54,81,108,32,16,16,58,34,24,82,67,15,119,74,45,"{'F': 16, 'P': 11}","{'C': 22, 'J': 16, 'Z': 16}","{'Q': 24, 'R': 16, 'S': 8, 'T': 8, 'H': 16, 'M': 8}","{'Y': 8, 'A': 8, 'B': 4, 'D': 4, 'E': 4, 'G': 8, 'I': 4, 'K': 8, 'L': 4, 'N': 4, 'O': 4, 'U': 8, 'V': 4, 'W': 4, 'X': 4}"
INV-ZZ-0000083,SCH-ZZ-0000083,1019,Boeing 787,08/19/2024,08/19/2024,BOM,DUB,270,296,201,-69,95,27,54,81,108,28,15,13,57,34,23,88,48,40,123,104,19,"{'F': 16, 'P': 11}","{'C': 22, 'J': 16, 'Z': 16}","{'Q': 24, 'R': 16, 'S': 8, 'T': 8, 'H': 16, 'M': 8}","{'Y': 8, 'A': 8, 'B': 4, 'D': 4, 'E': 4, 'G': 8, 'I': 4, 'K': 8, 'L': 4, 'N': 4, 'O': 4, 'U': 8, 'V': 4, 'W': 4, 'X': 4}"
INV-ZZ-0000147,SCH-ZZ-0000147,1019,Boeing 787,08/19/2024,08/19/2024,BOM,DUB,270,287,223,-47,64,27,54,81,108,29,27,2,58,39,19,82,79,3,118,78,40,"{'F': 16, 'P': 11}","{'C': 22, 'J': 16, 'Z': 16}","{'Q': 24, 'R': 16, 'S': 8, 'T': 8, 'H': 16, 'M': 8}","{'Y': 8, 'A': 8, 'B': 4, 'D': 4, 'E': 4, 'G': 8, 'I': 4, 'K': 8, 'L': 4, 'N': 4, 'O': 4, 'U': 8, 'V': 4, 'W': 4, 'X': 4}"
INV-ZZ-0000020,SCH-ZZ-0000020,1020,Boeing 787,08/19/2024,08/19/2024,BOM,VNS,270,302,185,-85,117,27,54,81,108,32,11,21,58,45,13,88,45,43,124,84,40,"{'F': 16, 'P': 11}","{'C': 22, 'J': 16, 'Z': 16}","{'Q': 24, 'R': 16, 'S': 8, 'T': 8, 'H': 16, 'M': 8}","{'Y': 8, 'A': 8, 'B': 4, 'D': 4, 'E': 4, 'G': 8, 'I': 4, 'K': 8, 'L': 4, 'N': 4, 'O': 4, 'U': 8, 'V': 4, 'W': 4, 'X': 4}"
INV-ZZ-0000084,SCH-ZZ-0000084,1020,Boeing 787,08/19/2024,08/19/2024,BOM,VNS,270,288,182,-88,106,27,54,81,108,32,22,10,55,36,19,84,49,35,117,75,42,"{'F': 16, 'P': 11}","{'C': 22, 'J': 16, 'Z': 16}","{'Q': 24, 'R': 16, 'S': 8, 'T': 8, 'H': 16, 'M': 8}","{'Y': 8, 'A': 8, 'B': 4, 'D': 4, 'E': 4, 'G': 8, 'I': 4, 'K': 8, 'L': 4, 'N': 4, 'O': 4, 'U': 8, 'V': 4, 'W': 4, 'X': 4}"
INV-ZZ-0000148,SCH-ZZ-0000148,1020,Boeing 787,08/19/2024,08/19/2024,BOM,VNS,270,299,223,-47,76,27,54,81,108,30,25,5,55,35,20,87,77,10,127,86,41,"{'F': 16, 'P': 11}","{'C': 22, 'J': 16, 'Z': 16}","{'Q': 24, 'R': 16, 'S': 8, 'T': 8, 'H': 16, 'M': 8}","{'Y': 8, 'A': 8, 'B': 4, 'D': 4, 'E': 4, 'G': 8, 'I': 4, 'K': 8, 'L': 4, 'N': 4, 'O': 4, 'U': 8, 'V': 4, 'W': 4, 'X': 4}"
INV-ZZ-0000021,SCH-ZZ-0000021,1021,Boeing 787,08/19/2024,08/19/2024,BOM,JFK,270,285,147,-123,138,27,54,81,108,31,26,5,56,45,11,86,35,51,112,41,71,"{'F': 16, 'P': 11}","{'C': 22, 'J': 16, 'Z': 16}","{'Q': 24, 'R': 16, 'S': 8, 'T': 8, 'H': 16, 'M': 8}","{'Y': 8, 'A': 8, 'B': 4, 'D': 4, 'E': 4, 'G': 8, 'I': 4, 'K': 8, 'L': 4, 'N': 4, 'O': 4, 'U': 8, 'V': 4, 'W': 4, 'X': 4}"
INV-ZZ-0000085,SCH-ZZ-0000085,1021,Boeing 787,08/19/2024,08/19/2024,BOM,JFK,270,295,253,-17,42,27,54,81,108,32,25,7,55,40,15,91,80,11,117,108,9,"{'F': 16, 'P': 11}","{'C': 22, 'J': 16, 'Z': 16}","{'Q': 24, 'R': 16, 'S': 8, 'T': 8, 'H': 16, 'M': 8}","{'Y': 8, 'A': 8, 'B': 4, 'D': 4, 'E': 4, 'G': 8, 'I': 4, 'K': 8, 'L': 4, 'N': 4, 'O': 4, 'U': 8, 'V': 4, 'W': 4, 'X': 4}"
INV-ZZ-0000149,SCH-ZZ-0000149,1021,Boeing 787,08/19/2024,08/19/2024,BOM,JFK,270,300,174,-96,126,27,54,81,108,32,17,15,58,48,10,88,45,43,122,64,58,"{'F': 16, 'P': 11}","{'C': 22, 'J': 16, 'Z': 16}","{'Q': 24, 'R': 16, 'S': 8, 'T': 8, 'H': 16, 'M': 8}","{'Y': 8, 'A': 8, 'B': 4, 'D': 4, 'E': 4, 'G': 8, 'I': 4, 'K': 8, 'L': 4, 'N': 4, 'O': 4, 'U': 8, 'V': 4, 'W': 4, 'X': 4}"
INV-ZZ-0000022,SCH-ZZ-0000022,1022,Boeing 787,08/19/2024,08/19/2024,BOM,DEL,270,279,229,-41,50,27,54,81,108,29,23,6,55,45,10,86,60,26,109,101,8,"{'F': 16, 'P': 11}","{'C': 22, 'J': 16, 'Z': 16}","{'Q': 24, 'R': 16, 'S': 8, 'T': 8, 'H': 16, 'M': 8}","{'Y': 8, 'A': 8, 'B': 4, 'D': 4, 'E': 4, 'G': 8, 'I': 4, 'K': 8, 'L': 4, 'N': 4, 'O': 4, 'U': 8, 'V': 4, 'W': 4, 'X': 4}"
INV-ZZ-0000086,SCH-ZZ-0000086,1022,Boeing 787,08/19/2024,08/19/2024,BOM,DEL,270,296,218,-52,78,27,54,81,108,29,19,10,60,41,19,89,67,22,118,91,27,"{'F': 16, 'P': 11}","{'C': 22, 'J': 16, 'Z': 16}","{'Q': 24, 'R': 16, 'S': 8, 'T': 8, 'H': 16, 'M': 8}","{'Y': 8, 'A': 8, 'B': 4, 'D': 4, 'E': 4, 'G': 8, 'I': 4, 'K': 8, 'L': 4, 'N': 4, 'O': 4, 'U': 8, 'V': 4, 'W': 4, 'X': 4}"
INV-ZZ-0000150,SCH-ZZ-0000150,1022,Boeing 787,08/19/2024,08/19/2024,BOM,DEL,270,296,145,-125,151,27,54,81,108,29,12,17,61,25,36,86,61,25,120,47,73,"{'F': 16, 'P': 11}","{'C': 22, 'J': 16, 'Z': 16}","{'Q': 24, 'R': 16, 'S': 8, 'T': 8, 'H': 16, 'M': 8}","{'Y': 8, 'A': 8, 'B': 4, 'D': 4, 'E': 4, 'G': 8, 'I': 4, 'K': 8, 'L': 4, 'N': 4, 'O': 4, 'U': 8, 'V': 4, 'W': 4, 'X': 4}"
INV-ZZ-0000023,SCH-ZZ-0000023,1023,Boeing 787,08/19/2024,08/19/2024,BOM,LAX,270,306,199,-71,107,27,54,81,108,32,20,12,56,26,30,91,60,31,127,93,34,"{'F': 16, 'P': 11}","{'C': 22, 'J': 16, 'Z': 16}","{'Q': 24, 'R': 16, 'S': 8, 'T': 8, 'H': 16, 'M': 8}","{'Y': 8, 'A': 8, 'B': 4, 'D': 4, 'E': 4, 'G': 8, 'I': 4, 'K': 8, 'L': 4, 'N': 4, 'O': 4, 'U': 8, 'V': 4, 'W': 4, 'X': 4}"
INV-ZZ-0000087,SCH-ZZ-0000087,1023,Boeing 787,08/19/2024,08/19/2024,BOM,LAX,270,302,141,-129,161,27,54,81,108,31,10,21,57,26,31,88,64,24,126,41,85,"{'F': 16, 'P': 11}","{'C': 22, 'J': 16, 'Z': 16}","{'Q': 24, 'R': 16, 'S': 8, 'T': 8, 'H': 16, 'M': 8}","{'Y': 8, 'A': 8, 'B': 4, 'D': 4, 'E': 4, 'G': 8, 'I': 4, 'K': 8, 'L': 4, 'N': 4, 'O': 4, 'U': 8, 'V': 4, 'W': 4, 'X': 4}"
INV-ZZ-0000151,SCH-ZZ-0000151,1023,Boeing 787,08/19/2024,08/19/2024,BOM,LAX,270,298,136,-134,162,27,54,81,108,32,12,20,58,37,21,88,45,43,120,42,78,"{'F': 16, 'P': 11}","{'C': 22, 'J': 16, 'Z': 16}","{'Q': 24, 'R': 16, 'S': 8, 'T': 8, 'H': 16, 'M': 8}","{'Y': 8, 'A': 8, 'B': 4, 'D': 4, 'E': 4, 'G': 8, 'I': 4, 'K': 8, 'L': 4, 'N': 4, 'O': 4, 'U': 8, 'V': 4, 'W': 4, 'X': 4}"
INV-ZZ-0000024,SCH-ZZ-0000024,1024,Boeing 787,08/19/2024,08/19/2024,DUB,MAA,270,290,134,-136,156,27,54,81,108,30,15,15,61,39,22,86,35,51,113,45,68,"{'F': 16, 'P': 11}","{'C': 22, 'J': 16, 'Z': 16}","{'Q': 24, 'R': 16, 'S': 8, 'T': 8, 'H': 16, 'M': 8}","{'Y': 8, 'A': 8, 'B': 4, 'D': 4, 'E': 4, 'G': 8, 'I': 4, 'K': 8, 'L': 4, 'N': 4, 'O': 4, 'U': 8, 'V': 4, 'W': 4, 'X': 4}"
INV-ZZ-0000088,SCH-ZZ-0000088,1024,Boeing 787,08/19/2024,08/19/2024,DUB,MAA,270,291,226,-44,65,27,54,81,108,31,23,8,61,39,22,84,81,3,115,83,32,"{'F': 16, 'P': 11}","{'C': 22, 'J': 16, 'Z': 16}","{'Q': 24, 'R': 16, 'S': 8, 'T': 8, 'H': 16, 'M': 8}","{'Y': 8, 'A': 8, 'B': 4, 'D': 4, 'E': 4, 'G': 8, 'I': 4, 'K': 8, 'L': 4, 'N': 4, 'O': 4, 'U': 8, 'V': 4, 'W': 4, 'X': 4}"
INV-ZZ-0000152,SCH-ZZ-0000152,1024,Boeing 787,08/19/2024,08/19/2024,DUB,MAA,270,287,177,-93,110,27,54,81,108,32,17,15,59,30,29,83,41,42,113,89,24,"{'F': 16, 'P': 11}","{'C': 22, 'J': 16, 'Z': 16}","{'Q': 24, 'R': 16, 'S': 8, 'T': 8, 'H': 16, 'M': 8}","{'Y': 8, 'A': 8, 'B': 4, 'D': 4, 'E': 4, 'G': 8, 'I': 4, 'K': 8, 'L': 4, 'N': 4, 'O': 4, 'U': 8, 'V': 4, 'W': 4, 'X': 4}"
INV-ZZ-0000025,SCH-ZZ-0000025,1025,Boeing 787,08/19/2024,08/19/2024,DUB,BLR,270,292,204,-66,88,27,54,81,108,29,12,17,56,22,34,90,66,24,117,104,13,"{'F': 16, 'P': 11}","{'C': 22, 'J': 16, 'Z': 16}","{'Q': 24, 'R': 16, 'S': 8, 'T': 8, 'H': 16, 'M': 8}","{'Y': 8, 'A': 8, 'B': 4, 'D': 4, 'E': 4, 'G': 8, 'I': 4, 'K': 8, 'L': 4, 'N': 4, 'O': 4, 'U': 8, 'V': 4, 'W': 4, 'X': 4}"
INV-ZZ-0000089,SCH-ZZ-0000089,1025,Boeing 787,08/19/2024,08/19/2024,DUB,BLR,270,297,201,-69,96,27,54,81,108,32,12,20,61,48,13,85,73,12,119,68,51,"{'F': 16, 'P': 11}","{'C': 22, 'J': 16, 'Z': 16}","{'Q': 24, 'R': 16, 'S': 8, 'T': 8, 'H': 16, 'M': 8}","{'Y': 8, 'A': 8, 'B': 4, 'D': 4, 'E': 4, 'G': 8, 'I': 4, 'K': 8, 'L': 4, 'N': 4, 'O': 4, 'U': 8, 'V': 4, 'W': 4, 'X': 4}"
INV-ZZ-0000153,SCH-ZZ-0000153,1025,Boeing 787,08/19/2024,08/19/2024,DUB,BLR,270,303,180,-90,123,27,54,81,108,31,17,14,58,26,32,88,53,35,126,84,42,"{'F': 16, 'P': 11}","{'C': 22, 'J': 16, 'Z': 16}","{'Q': 24, 'R': 16, 'S': 8, 'T': 8, 'H': 16, 'M': 8}","{'Y': 8, 'A': 8, 'B': 4, 'D': 4, 'E': 4, 'G': 8, 'I': 4, 'K': 8, 'L': 4, 'N': 4, 'O': 4, 'U': 8, 'V': 4, 'W': 4, 'X': 4}"
INV-ZZ-0000026,SCH-ZZ-0000026,1026,Boeing 787,08/19/2024,08/19/2024,DUB,BOM,270,280,188,-82,92,27,54,81,108,32,21,11,57,30,27,82,40,42,109,97,12,"{'F': 16, 'P': 11}","{'C': 22, 'J': 16, 'Z': 16}","{'Q': 24, 'R': 16, 'S': 8, 'T': 8, 'H': 16, 'M': 8}","{'Y': 8, 'A': 8, 'B': 4, 'D': 4, 'E': 4, 'G': 8, 'I': 4, 'K': 8, 'L': 4, 'N': 4, 'O': 4, 'U': 8, 'V': 4, 'W': 4, 'X': 4}"
INV-ZZ-0000090,SCH-ZZ-0000090,1026,Boeing 787,08/19/2024,08/19/2024,DUB,BOM,270,281,245,-25,36,27,54,81,108,29,27,2,55,41,14,82,79,3,115,98,17,"{'F': 16, 'P': 11}","{'C': 22, 'J': 16, 'Z': 16}","{'Q': 24, 'R': 16, 'S': 8, 'T': 8, 'H': 16, 'M': 8}","{'Y': 8, 'A': 8, 'B': 4, 'D': 4, 'E': 4, 'G': 8, 'I': 4, 'K': 8, 'L': 4, 'N': 4, 'O': 4, 'U': 8, 'V': 4, 'W': 4, 'X': 4}"
INV-ZZ-0000154,SCH-ZZ-0000154,1026,Boeing 787,08/19/2024,08/19/2024,DUB,BOM,270,290,196,-74,94,27,54,81,108,28,25,3,59,23,36,89,40,49,114,108,6,"{'F': 16, 'P': 11}","{'C': 22, 'J': 16, 'Z': 16}","{'Q': 24, 'R': 16, 'S': 8, 'T': 8, 'H': 16, 'M': 8}","{'Y': 8, 'A': 8, 'B': 4, 'D': 4, 'E': 4, 'G': 8, 'I': 4, 'K': 8, 'L': 4, 'N': 4, 'O': 4, 'U': 8, 'V': 4, 'W': 4, 'X': 4}"
INV-ZZ-0000028,SCH-ZZ-0000028,1028,Boeing 787,08/19/2024,08/19/2024,DUB,VNS,270,282,183,-87,99,27,54,81,108,28,11,17,59,49,10,86,50,36,109,73,36,"{'F': 16, 'P': 11}","{'C': 22, 'J': 16, 'Z': 16}","{'Q': 24, 'R': 16, 'S': 8, 'T': 8, 'H': 16, 'M': 8}","{'Y': 8, 'A': 8, 'B': 4, 'D': 4, 'E': 4, 'G': 8, 'I': 4, 'K': 8, 'L': 4, 'N': 4, 'O': 4, 'U': 8, 'V': 4, 'W': 4, 'X': 4}"
INV-ZZ-0000092,SCH-ZZ-0000092,1028,Boeing 787,08/19/2024,08/19/2024,DUB,VNS,270,287,195,-75,92,27,54,81,108,28,13,15,59,48,11,86,58,28,114,76,38,"{'F': 16, 'P': 11}","{'C': 22, 'J': 16, 'Z': 16}","{'Q': 24, 'R': 16, 'S': 8, 'T': 8, 'H': 16, 'M': 8}","{'Y': 8, 'A': 8, 'B': 4, 'D': 4, 'E': 4, 'G': 8, 'I': 4, 'K': 8, 'L': 4, 'N': 4, 'O': 4, 'U': 8, 'V': 4, 'W': 4, 'X': 4}"
INV-ZZ-0000156,SCH-ZZ-0000156,1028,Boeing 787,08/19/2024,08/19/2024,DUB,VNS,270,284,182,-88,102,27,54,81,108,30,19,11,58,52,6,85,45,40,111,66,45,"{'F': 16, 'P': 11}","{'C': 22, 'J': 16, 'Z': 16}","{'Q': 24, 'R': 16, 'S': 8, 'T': 8, 'H': 16, 'M': 8}","{'Y': 8, 'A': 8, 'B': 4, 'D': 4, 'E': 4, 'G': 8, 'I': 4, 'K': 8, 'L': 4, 'N': 4, 'O': 4, 'U': 8, 'V': 4, 'W': 4, 'X': 4}"
INV-ZZ-0000029,SCH-ZZ-0000029,1029,Boeing 787,08/19/2024,08/19/2024,DUB,JFK,270,310,129,-141,181,27,54,81,108,32,12,20,61,23,38,91,41,50,126,53,73,"{'F': 16, 'P': 11}","{'C': 22, 'J': 16, 'Z': 16}","{'Q': 24, 'R': 16, 'S': 8, 'T': 8, 'H': 16, 'M': 8}","{'Y': 8, 'A': 8, 'B': 4, 'D': 4, 'E': 4, 'G': 8, 'I': 4, 'K': 8, 'L': 4, 'N': 4, 'O': 4, 'U': 8, 'V': 4, 'W': 4, 'X': 4}"
INV-ZZ-0000093,SCH-ZZ-0000093,1029,Boeing 787,08/19/2024,08/19/2024,DUB,JFK,270,284,188,-82,96,27,54,81,108,30,26,4,55,35,20,83,78,5,116,49,67,"{'F': 16, 'P': 11}","{'C': 22, 'J': 16, 'Z': 16}","{'Q': 24, 'R': 16, 'S': 8, 'T': 8, 'H': 16, 'M': 8}","{'Y': 8, 'A': 8, 'B': 4, 'D': 4, 'E': 4, 'G': 8, 'I': 4, 'K': 8, 'L': 4, 'N': 4, 'O': 4, 'U': 8, 'V': 4, 'W': 4, 'X': 4}"
INV-ZZ-0000157,SCH-ZZ-0000157,1029,Boeing 787,08/19/2024,08/19/2024,DUB,JFK,270,297,159,-111,138,27,54,81,108,28,14,14,60,26,34,83,47,36,126,72,54,"{'F': 16, 'P': 11}","{'C': 22, 'J': 16, 'Z': 16}","{'Q': 24, 'R': 16, 'S': 8, 'T': 8, 'H': 16, 'M': 8}","{'Y': 8, 'A': 8, 'B': 4, 'D': 4, 'E': 4, 'G': 8, 'I': 4, 'K': 8, 'L': 4, 'N': 4, 'O': 4, 'U': 8, 'V': 4, 'W': 4, 'X': 4}"
INV-ZZ-0000030,SCH-ZZ-0000030,1030,Boeing 787,08/19/2024,08/19/2024,DUB,DEL,270,299,228,-42,71,27,54,81,108,30,19,11,57,54,3,90,60,30,122,95,27,"{'F': 16, 'P': 11}","{'C': 22, 'J': 16, 'Z': 16}","{'Q': 24, 'R': 16, 'S': 8, 'T': 8, 'H': 16, 'M': 8}","{'Y': 8, 'A': 8, 'B': 4, 'D': 4, 'E': 4, 'G': 8, 'I': 4, 'K': 8, 'L': 4, 'N': 4, 'O': 4, 'U': 8, 'V': 4, 'W': 4, 'X': 4}"
INV-ZZ-0000094,SCH-ZZ-0000094,1030,Boeing 787,08/19/2024,08/19/2024,DUB,DEL,270,291,166,-104,125,27,54,81,108,32,26,6,61,32,29,85,57,28,113,51,62,"{'F': 16, 'P': 11}","{'C': 22, 'J': 16, 'Z': 16}","{'Q': 24, 'R': 16, 'S': 8, 'T': 8, 'H': 16, 'M': 8}","{'Y': 8, 'A': 8, 'B': 4, 'D': 4, 'E': 4, 'G': 8, 'I': 4, 'K': 8, 'L': 4, 'N': 4, 'O': 4, 'U': 8, 'V': 4, 'W': 4, 'X': 4}"
INV-ZZ-0000158,SCH-ZZ-0000158,1030,Boeing 787,08/19/2024,08/19/2024,DUB,DEL,270,291,143,-127,148,27,54,81,108,32,10,22,57,26,31,88,51,37,114,56,58,"{'F': 16, 'P': 11}","{'C': 22, 'J': 16, 'Z': 16}","{'Q': 24, 'R': 16, 'S': 8, 'T': 8, 'H': 16, 'M': 8}","{'Y': 8, 'A': 8, 'B': 4, 'D': 4, 'E': 4, 'G': 8, 'I': 4, 'K': 8, 'L': 4, 'N': 4, 'O': 4, 'U': 8, 'V': 4, 'W': 4, 'X': 4}"
INV-ZZ-0000031,SCH-ZZ-0000031,1031,Boeing 787,08/19/2024,08/19/2024,DUB,LAX,270,296,195,-75,101,27,54,81,108,29,18,11,57,36,21,88,43,45,122,98,24,"{'F': 16, 'P': 11}","{'C': 22, 'J': 16, 'Z': 16}","{'Q': 24, 'R': 16, 'S': 8, 'T': 8, 'H': 16, 'M': 8}","{'Y': 8, 'A': 8, 'B': 4, 'D': 4, 'E': 4, 'G': 8, 'I': 4, 'K': 8, 'L': 4, 'N': 4, 'O': 4, 'U': 8, 'V': 4, 'W': 4, 'X': 4}"
INV-ZZ-0000095,SCH-ZZ-0000095,1031,Boeing 787,08/19/2024,08/19/2024,DUB,LAX,270,294,208,-62,86,27,54,81,108,29,16,13,55,43,12,84,41,43,126,108,18,"{'F': 16, 'P': 11}","{'C': 22, 'J': 16, 'Z': 16}","{'Q': 24, 'R': 16, 'S': 8, 'T': 8, 'H': 16, 'M': 8}","{'Y': 8, 'A': 8, 'B': 4, 'D': 4, 'E': 4, 'G': 8, 'I': 4, 'K': 8, 'L': 4, 'N': 4, 'O': 4, 'U': 8, 'V': 4, 'W': 4, 'X': 4}"
INV-ZZ-0000159,SCH-ZZ-0000159,1031,Boeing 787,08/19/2024,08/19/2024,DUB,LAX,270,279,208,-62,71,27,54,81,108,30,26,4,56,47,9,83,76,7,110,59,51,"{'F': 16, 'P': 11}","{'C': 22, 'J': 16, 'Z': 16}","{'Q': 24, 'R': 16, 'S': 8, 'T': 8, 'H': 16, 'M': 8}","{'Y': 8, 'A': 8, 'B': 4, 'D': 4, 'E': 4, 'G': 8, 'I': 4, 'K': 8, 'L': 4, 'N': 4, 'O': 4, 'U': 8, 'V': 4, 'W': 4, 'X': 4}"
INV-ZZ-0000032,SCH-ZZ-0000032,1032,Boeing 787,08/19/2024,08/19/2024,VNS,MAA,270,301,176,-94,125,27,54,81,108,29,13,16,58,30,28,89,61,28,125,72,53,"{'F': 16, 'P': 11}","{'C': 22, 'J': 16, 'Z': 16}","{'Q': 24, 'R': 16, 'S': 8, 'T': 8, 'H': 16, 'M': 8}","{'Y': 8, 'A': 8, 'B': 4, 'D': 4, 'E': 4, 'G': 8, 'I': 4, 'K': 8, 'L': 4, 'N': 4, 'O': 4, 'U': 8, 'V': 4, 'W': 4, 'X': 4}"
INV-ZZ-0000096,SCH-ZZ-0000096,1032,Boeing 787,08/19/2024,08/19/2024,VNS,MAA,270,301,176,-94,125,27,54,81,108,31,20,11,57,50,7,86,61,25,127,45,82,"{'F': 16, 'P': 11}","{'C': 22, 'J': 16, 'Z': 16}","{'Q': 24, 'R': 16, 'S': 8, 'T': 8, 'H': 16, 'M': 8}","{'Y': 8, 'A': 8, 'B': 4, 'D': 4, 'E': 4, 'G': 8, 'I': 4, 'K': 8, 'L': 4, 'N': 4, 'O': 4, 'U': 8, 'V': 4, 'W': 4, 'X': 4}"
INV-ZZ-0000160,SCH-ZZ-0000160,1032,Boeing 787,08/19/2024,08/19/2024,VNS,MAA,270,287,153,-117,134,27,54,81,108,28,13,15,58,36,22,91,51,40,110,53,57,"{'F': 16, 'P': 11}","{'C': 22, 'J': 16, 'Z': 16}","{'Q': 24, 'R': 16, 'S': 8, 'T': 8, 'H': 16, 'M': 8}","{'Y': 8, 'A': 8, 'B': 4, 'D': 4, 'E': 4, 'G': 8, 'I': 4, 'K': 8, 'L': 4, 'N': 4, 'O': 4, 'U': 8, 'V': 4, 'W': 4, 'X': 4}"
INV-ZZ-0000033,SCH-ZZ-0000033,1033,Boeing 787,08/19/2024,08/19/2024,VNS,BLR,270,293,142,-128,151,27,54,81,108,31,16,15,57,26,31,83,38,45,122,62,60,"{'F': 16, 'P': 11}","{'C': 22, 'J': 16, 'Z': 16}","{'Q': 24, 'R': 16, 'S': 8, 'T': 8, 'H': 16, 'M': 8}","{'Y': 8, 'A': 8, 'B': 4, 'D': 4, 'E': 4, 'G': 8, 'I': 4, 'K': 8, 'L': 4, 'N': 4, 'O': 4, 'U': 8, 'V': 4, 'W': 4, 'X': 4}"
INV-ZZ-0000097,SCH-ZZ-0000097,1033,Boeing 787,08/19/2024,08/19/2024,VNS,BLR,270,289,180,-90,109,27,54,81,108,31,27,4,58,25,33,82,64,18,118,64,54,"{'F': 16, 'P': 11}","{'C': 22, 'J': 16, 'Z': 16}","{'Q': 24, 'R': 16, 'S': 8, 'T': 8, 'H': 16, 'M': 8}","{'Y': 8, 'A': 8, 'B': 4, 'D': 4, 'E': 4, 'G': 8, 'I': 4, 'K': 8, 'L': 4, 'N': 4, 'O': 4, 'U': 8, 'V': 4, 'W': 4, 'X': 4}"
INV-ZZ-0000161,SCH-ZZ-0000161,1033,Boeing 787,08/19/2024,08/19/2024,VNS,BLR,270,284,162,-108,122,27,54,81,108,29,13,16,57,45,12,85,35,50,113,69,44,"{'F': 16, 'P': 11}","{'C': 22, 'J': 16, 'Z': 16}","{'Q': 24, 'R': 16, 'S': 8, 'T': 8, 'H': 16, 'M': 8}","{'Y': 8, 'A': 8, 'B': 4, 'D': 4, 'E': 4, 'G': 8, 'I': 4, 'K': 8, 'L': 4, 'N': 4, 'O': 4, 'U': 8, 'V': 4, 'W': 4, 'X': 4}"
INV-ZZ-0000034,SCH-ZZ-0000034,1034,Boeing 787,08/19/2024,08/19/2024,VNS,BOM,270,300,186,-84,114,27,54,81,108,30,23,7,55,43,12,91,67,24,124,53,71,"{'F': 16, 'P': 11}","{'C': 22, 'J': 16, 'Z': 16}","{'Q': 24, 'R': 16, 'S': 8, 'T': 8, 'H': 16, 'M': 8}","{'Y': 8, 'A': 8, 'B': 4, 'D': 4, 'E': 4, 'G': 8, 'I': 4, 'K': 8, 'L': 4, 'N': 4, 'O': 4, 'U': 8, 'V': 4, 'W': 4, 'X': 4}"
INV-ZZ-0000098,SCH-ZZ-0000098,1034,Boeing 787,08/19/2024,08/19/2024,VNS,BOM,270,302,193,-77,109,27,54,81,108,32,25,7,57,54,3,86,50,36,127,64,63,"{'F': 16, 'P': 11}","{'C': 22, 'J': 16, 'Z': 16}","{'Q': 24, 'R': 16, 'S': 8, 'T': 8, 'H': 16, 'M': 8}","{'Y': 8, 'A': 8, 'B': 4, 'D': 4, 'E': 4, 'G': 8, 'I': 4, 'K': 8, 'L': 4, 'N': 4, 'O': 4, 'U': 8, 'V': 4, 'W': 4, 'X': 4}"
INV-ZZ-0000162,SCH-ZZ-0000162,1034,Boeing 787,08/19/2024,08/19/2024,VNS,BOM,270,292,169,-101,123,27,54,81,108,28,19,9,61,47,14,85,56,29,118,47,71,"{'F': 16, 'P': 11}","{'C': 22, 'J': 16, 'Z': 16}","{'Q': 24, 'R': 16, 'S': 8, 'T': 8, 'H': 16, 'M': 8}","{'Y': 8, 'A': 8, 'B': 4, 'D': 4, 'E': 4, 'G': 8, 'I': 4, 'K': 8, 'L': 4, 'N': 4, 'O': 4, 'U': 8, 'V': 4, 'W': 4, 'X': 4}"
INV-ZZ-0000035,SCH-ZZ-0000035,1035,Boeing 787,08/19/2024,08/19/2024,VNS,DUB,270,283,206,-64,77,27,54,81,108,29,21,8,59,49,10,83,72,11,112,64,48,"{'F': 16, 'P': 11}","{'C': 22, 'J': 16, 'Z': 16}","{'Q': 24, 'R': 16, 'S': 8, 'T': 8, 'H': 16, 'M': 8}","{'Y': 8, 'A': 8, 'B': 4, 'D': 4, 'E': 4, 'G': 8, 'I': 4, 'K': 8, 'L': 4, 'N': 4, 'O': 4, 'U': 8, 'V': 4, 'W': 4, 'X': 4}"
INV-ZZ-0000099,SCH-ZZ-0000099,1035,Boeing 787,08/19/2024,08/19/2024,VNS,DUB,270,290,211,-59,79,27,54,81,108,29,26,3,58,54,4,86,53,33,117,78,39,"{'F': 16, 'P': 11}","{'C': 22, 'J': 16, 'Z': 16}","{'Q': 24, 'R': 16, 'S': 8, 'T': 8, 'H': 16, 'M': 8}","{'Y': 8, 'A': 8, 'B': 4, 'D': 4, 'E': 4, 'G': 8, 'I': 4, 'K': 8, 'L': 4, 'N': 4, 'O': 4, 'U': 8, 'V': 4, 'W': 4, 'X': 4}"
INV-ZZ-0000163,SCH-ZZ-0000163,1035,Boeing 787,08/19/2024,08/19/2024,VNS,DUB,270,289,143,-127,146,27,54,81,108,30,22,8,59,39,20,83,39,44,117,43,74,"{'F': 16, 'P': 11}","{'C': 22, 'J': 16, 'Z': 16}","{'Q': 24, 'R': 16, 'S': 8, 'T': 8, 'H': 16, 'M': 8}","{'Y': 8, 'A': 8, 'B': 4, 'D': 4, 'E': 4, 'G': 8, 'I': 4, 'K': 8, 'L': 4, 'N': 4, 'O': 4, 'U': 8, 'V': 4, 'W': 4, 'X': 4}"
INV-ZZ-0000037,SCH-ZZ-0000037,1037,Boeing 787,08/19/2024,08/19/2024,VNS,JFK,270,298,171,-99,127,27,54,81,108,31,12,19,56,30,26,88,65,23,123,64,59,"{'F': 16, 'P': 11}","{'C': 22, 'J': 16, 'Z': 16}","{'Q': 24, 'R': 16, 'S': 8, 'T': 8, 'H': 16, 'M': 8}","{'Y': 8, 'A': 8, 'B': 4, 'D': 4, 'E': 4, 'G': 8, 'I': 4, 'K': 8, 'L': 4, 'N': 4, 'O': 4, 'U': 8, 'V': 4, 'W': 4, 'X': 4}"
INV-ZZ-0000101,SCH-ZZ-0000101,1037,Boeing 787,08/19/2024,08/19/2024,VNS,JFK,270,294,151,-119,143,27,54,81,108,28,10,18,58,51,7,87,37,50,121,53,68,"{'F': 16, 'P': 11}","{'C': 22, 'J': 16, 'Z': 16}","{'Q': 24, 'R': 16, 'S': 8, 'T': 8, 'H': 16, 'M': 8}","{'Y': 8, 'A': 8, 'B': 4, 'D': 4, 'E': 4, 'G': 8, 'I': 4, 'K': 8, 'L': 4, 'N': 4, 'O': 4, 'U': 8, 'V': 4, 'W': 4, 'X': 4}"
INV-ZZ-0000165,SCH-ZZ-0000165,1037,Boeing 787,08/19/2024,08/19/2024,VNS,JFK,270,296,190,-80,106,27,54,81,108,31,21,10,56,28,28,91,53,38,118,88,30,"{'F': 16, 'P': 11}","{'C': 22, 'J': 16, 'Z': 16}","{'Q': 24, 'R': 16, 'S': 8, 'T': 8, 'H': 16, 'M': 8}","{'Y': 8, 'A': 8, 'B': 4, 'D': 4, 'E': 4, 'G': 8, 'I': 4, 'K': 8, 'L': 4, 'N': 4, 'O': 4, 'U': 8, 'V': 4, 'W': 4, 'X': 4}"
INV-ZZ-0000038,SCH-ZZ-0000038,1038,Boeing 787,08/19/2024,08/19/2024,VNS,DEL,270,290,206,-64,84,27,54,81,108,31,22,9,59,20,39,86,63,23,114,101,13,"{'F': 16, 'P': 11}","{'C': 22, 'J': 16, 'Z': 16}","{'Q': 24, 'R': 16, 'S': 8, 'T': 8, 'H': 16, 'M': 8}","{'Y': 8, 'A': 8, 'B': 4, 'D': 4, 'E': 4, 'G': 8, 'I': 4, 'K': 8, 'L': 4, 'N': 4, 'O': 4, 'U': 8, 'V': 4, 'W': 4, 'X': 4}"
INV-ZZ-0000102,SCH-ZZ-0000102,1038,Boeing 787,08/19/2024,08/19/2024,VNS,DEL,270,297,169,-101,128,27,54,81,108,29,23,6,60,32,28,89,67,22,119,47,72,"{'F': 16, 'P': 11}","{'C': 22, 'J': 16, 'Z': 16}","{'Q': 24, 'R': 16, 'S': 8, 'T': 8, 'H': 16, 'M': 8}","{'Y': 8, 'A': 8, 'B': 4, 'D': 4, 'E': 4, 'G': 8, 'I': 4, 'K': 8, 'L': 4, 'N': 4, 'O': 4, 'U': 8, 'V': 4, 'W': 4, 'X': 4}"
INV-ZZ-0000166,SCH-ZZ-0000166,1038,Boeing 787,08/19/2024,08/19/2024,VNS,DEL,270,299,230,-40,69,27,54,81,108,28,23,5,56,51,5,91,68,23,124,88,36,"{'F': 16, 'P': 11}","{'C': 22, 'J': 16, 'Z': 16}","{'Q': 24, 'R': 16, 'S': 8, 'T': 8, 'H': 16, 'M': 8}","{'Y': 8, 'A': 8, 'B': 4, 'D': 4, 'E': 4, 'G': 8, 'I': 4, 'K': 8, 'L': 4, 'N': 4, 'O': 4, 'U': 8, 'V': 4, 'W': 4, 'X': 4}"
INV-ZZ-0000039,SCH-ZZ-0000039,1039,Boeing 787,08/19/2024,08/19/2024,VNS,LAX,270,300,154,-116,146,27,54,81,108,29,18,11,59,42,17,85,46,39,127,48,79,"{'F': 16, 'P': 11}","{'C': 22, 'J': 16, 'Z': 16}","{'Q': 24, 'R': 16, 'S': 8, 'T': 8, 'H': 16, 'M': 8}","{'Y': 8, 'A': 8, 'B': 4, 'D': 4, 'E': 4, 'G': 8, 'I': 4, 'K': 8, 'L': 4, 'N': 4, 'O': 4, 'U': 8, 'V': 4, 'W': 4, 'X': 4}"
INV-ZZ-0000103,SCH-ZZ-0000103,1039,Boeing 787,08/19/2024,08/19/2024,VNS,LAX,270,291,193,-77,98,27,54,81,108,28,20,8,56,46,10,88,72,16,119,55,64,"{'F': 16, 'P': 11}","{'C': 22, 'J': 16, 'Z': 16}","{'Q': 24, 'R': 16, 'S': 8, 'T': 8, 'H': 16, 'M': 8}","{'Y': 8, 'A': 8, 'B': 4, 'D': 4, 'E': 4, 'G': 8, 'I': 4, 'K': 8, 'L': 4, 'N': 4, 'O': 4, 'U': 8, 'V': 4, 'W': 4, 'X': 4}"
INV-ZZ-0000167,SCH-ZZ-0000167,1039,Boeing 787,08/19/2024,08/19/2024,VNS,LAX,270,286,188,-82,98,27,54,81,108,30,20,10,56,51,5,85,51,34,115,66,49,"{'F': 16, 'P': 11}","{'C': 22, 'J': 16, 'Z': 16}","{'Q': 24, 'R': 16, 'S': 8, 'T': 8, 'H': 16, 'M': 8}","{'Y': 8, 'A': 8, 'B': 4, 'D': 4, 'E': 4, 'G': 8, 'I': 4, 'K': 8, 'L': 4, 'N': 4, 'O': 4, 'U': 8, 'V': 4, 'W': 4, 'X': 4}"
INV-ZZ-0000040,SCH-ZZ-0000040,1040,Boeing 787,08/19/2024,08/19/2024,JFK,MAA,270,290,202,-68,88,27,54,81,108,32,14,18,59,52,7,88,62,26,111,74,37,"{'F': 16, 'P': 11}","{'C': 22, 'J': 16, 'Z': 16}","{'Q': 24, 'R': 16, 'S': 8, 'T': 8, 'H': 16, 'M': 8}","{'Y': 8, 'A': 8, 'B': 4, 'D': 4, 'E': 4, 'G': 8, 'I': 4, 'K': 8, 'L': 4, 'N': 4, 'O': 4, 'U': 8, 'V': 4, 'W': 4, 'X': 4}"
INV-ZZ-0000104,SCH-ZZ-0000104,1040,Boeing 787,08/19/2024,08/19/2024,JFK,MAA,270,297,226,-44,71,27,54,81,108,31,20,11,58,32,26,82,81,1,126,93,33,"{'F': 16, 'P': 11}","{'C': 22, 'J': 16, 'Z': 16}","{'Q': 24, 'R': 16, 'S': 8, 'T': 8, 'H': 16, 'M': 8}","{'Y': 8, 'A': 8, 'B': 4, 'D': 4, 'E': 4, 'G': 8, 'I': 4, 'K': 8, 'L': 4, 'N': 4, 'O': 4, 'U': 8, 'V': 4, 'W': 4, 'X': 4}"
INV-ZZ-0000168,SCH-ZZ-0000168,1040,Boeing 787,08/19/2024,08/19/2024,JFK,MAA,270,286,195,-75,91,27,54,81,108,32,22,10,57,42,15,83,51,32,114,80,34,"{'F': 16, 'P': 11}","{'C': 22, 'J': 16, 'Z': 16}","{'Q': 24, 'R': 16, 'S': 8, 'T': 8, 'H': 16, 'M': 8}","{'Y': 8, 'A': 8, 'B': 4, 'D': 4, 'E': 4, 'G': 8, 'I': 4, 'K': 8, 'L': 4, 'N': 4, 'O': 4, 'U': 8, 'V': 4, 'W': 4, 'X': 4}"
INV-ZZ-0000041,SCH-ZZ-0000041,1041,Boeing 787,08/19/2024,08/19/2024,JFK,BLR,270,289,195,-75,94,27,54,81,108,28,23,5,61,26,35,86,46,40,114,100,14,"{'F': 16, 'P': 11}","{'C': 22, 'J': 16, 'Z': 16}","{'Q': 24, 'R': 16, 'S': 8, 'T': 8, 'H': 16, 'M': 8}","{'Y': 8, 'A': 8, 'B': 4, 'D': 4, 'E': 4, 'G': 8, 'I': 4, 'K': 8, 'L': 4, 'N': 4, 'O': 4, 'U': 8, 'V': 4, 'W': 4, 'X': 4}"
INV-ZZ-0000105,SCH-ZZ-0000105,1041,Boeing 787,08/19/2024,08/19/2024,JFK,BLR,270,287,203,-67,84,27,54,81,108,31,20,11,61,45,16,84,61,23,111,77,34,"{'F': 16, 'P': 11}","{'C': 22, 'J': 16, 'Z': 16}","{'Q': 24, 'R': 16, 'S': 8, 'T': 8, 'H': 16, 'M': 8}","{'Y': 8, 'A': 8, 'B': 4, 'D': 4, 'E': 4, 'G': 8, 'I': 4, 'K': 8, 'L': 4, 'N': 4, 'O': 4, 'U': 8, 'V': 4, 'W': 4, 'X': 4}"
INV-ZZ-0000169,SCH-ZZ-0000169,1041,Boeing 787,08/19/2024,08/19/2024,JFK,BLR,270,300,182,-88,118,27,54,81,108,30,17,13,59,39,20,89,64,25,122,62,60,"{'F': 16, 'P': 11}","{'C': 22, 'J': 16, 'Z': 16}","{'Q': 24, 'R': 16, 'S': 8, 'T': 8, 'H': 16, 'M': 8}","{'Y': 8, 'A': 8, 'B': 4, 'D': 4, 'E': 4, 'G': 8, 'I': 4, 'K': 8, 'L': 4, 'N': 4, 'O': 4, 'U': 8, 'V': 4, 'W': 4, 'X': 4}"
INV-ZZ-0000042,SCH-ZZ-0000042,1042,Boeing 787,08/19/2024,08/19/2024,JFK,BOM,270,282,207,-63,75,27,54,81,108,30,17,13,57,53,4,85,47,38,110,90,20,"{'F': 16, 'P': 11}","{'C': 22, 'J': 16, 'Z': 16}","{'Q': 24, 'R': 16, 'S': 8, 'T': 8, 'H': 16, 'M': 8}","{'Y': 8, 'A': 8, 'B': 4, 'D': 4, 'E': 4, 'G': 8, 'I': 4, 'K': 8, 'L': 4, 'N': 4, 'O': 4, 'U': 8, 'V': 4, 'W': 4, 'X': 4}"
INV-ZZ-0000106,SCH-ZZ-0000106,1042,Boeing 787,08/19/2024,08/19/2024,JFK,BOM,270,303,181,-89,122,27,54,81,108,32,23,9,61,27,34,88,65,23,122,66,56,"{'F': 16, 'P': 11}","{'C': 22, 'J': 16, 'Z': 16}","{'Q': 24, 'R': 16, 'S': 8, 'T': 8, 'H': 16, 'M': 8}","{'Y': 8, 'A': 8, 'B': 4, 'D': 4, 'E': 4, 'G': 8, 'I': 4, 'K': 8, 'L': 4, 'N': 4, 'O': 4, 'U': 8, 'V': 4, 'W': 4, 'X': 4}"
INV-ZZ-0000170,SCH-ZZ-0000170,1042,Boeing 787,08/19/2024,08/19/2024,JFK,BOM,270,283,140,-130,143,27,54,81,108,30,13,17,59,46,13,83,35,48,111,46,65,"{'F': 16, 'P': 11}","{'C': 22, 'J': 16, 'Z': 16}","{'Q': 24, 'R': 16, 'S': 8, 'T': 8, 'H': 16, 'M': 8}","{'Y': 8, 'A': 8, 'B': 4, 'D': 4, 'E': 4, 'G': 8, 'I': 4, 'K': 8, 'L': 4, 'N': 4, 'O': 4, 'U': 8, 'V': 4, 'W': 4, 'X': 4}"
INV-ZZ-0000043,SCH-ZZ-0000043,1043,Boeing 787,08/19/2024,08/19/2024,JFK,DUB,270,291,165,-105,126,27,54,81,108,32,15,17,59,29,30,91,77,14,109,44,65,"{'F': 16, 'P': 11}","{'C': 22, 'J': 16, 'Z': 16}","{'Q': 24, 'R': 16, 'S': 8, 'T': 8, 'H': 16, 'M': 8}","{'Y': 8, 'A': 8, 'B': 4, 'D': 4, 'E': 4, 'G': 8, 'I': 4, 'K': 8, 'L': 4, 'N': 4, 'O': 4, 'U': 8, 'V': 4, 'W': 4, 'X': 4}"
INV-ZZ-0000107,SCH-ZZ-0000107,1043,Boeing 787,08/19/2024,08/19/2024,JFK,DUB,270,299,184,-86,115,27,54,81,108,32,11,21,55,34,21,86,58,28,126,81,45,"{'F': 16, 'P': 11}","{'C': 22, 'J': 16, 'Z': 16}","{'Q': 24, 'R': 16, 'S': 8, 'T': 8, 'H': 16, 'M': 8}","{'Y': 8, 'A': 8, 'B': 4, 'D': 4, 'E': 4, 'G': 8, 'I': 4, 'K': 8, 'L': 4, 'N': 4, 'O': 4, 'U': 8, 'V': 4, 'W': 4, 'X': 4}"
INV-ZZ-0000171,SCH-ZZ-0000171,1043,Boeing 787,08/19/2024,08/19/2024,JFK,DUB,270,292,176,-94,116,27,54,81,108,31,25,6,61,31,30,91,61,30,109,59,50,"{'F': 16, 'P': 11}","{'C': 22, 'J': 16, 'Z': 16}","{'Q': 24, 'R': 16, 'S': 8, 'T': 8, 'H': 16, 'M': 8}","{'Y': 8, 'A': 8, 'B': 4, 'D': 4, 'E': 4, 'G': 8, 'I': 4, 'K': 8, 'L': 4, 'N': 4, 'O': 4, 'U': 8, 'V': 4, 'W': 4, 'X': 4}"
INV-ZZ-0000044,SCH-ZZ-0000044,1044,Boeing 787,08/19/2024,08/19/2024,JFK,VNS,270,293,194,-76,99,27,54,81,108,30,23,7,59,26,33,85,75,10,119,70,49,"{'F': 16, 'P': 11}","{'C': 22, 'J': 16, 'Z': 16}","{'Q': 24, 'R': 16, 'S': 8, 'T': 8, 'H': 16, 'M': 8}","{'Y': 8, 'A': 8, 'B': 4, 'D': 4, 'E': 4, 'G': 8, 'I': 4, 'K': 8, 'L': 4, 'N': 4, 'O': 4, 'U': 8, 'V': 4, 'W': 4, 'X': 4}"
INV-ZZ-0000108,SCH-ZZ-0000108,1044,Boeing 787,08/19/2024,08/19/2024,JFK,VNS,270,301,179,-91,122,27,54,81,108,31,12,19,57,21,36,85,78,7,128,68,60,"{'F': 16, 'P': 11}","{'C': 22, 'J': 16, 'Z': 16}","{'Q': 24, 'R': 16, 'S': 8, 'T': 8, 'H': 16, 'M': 8}","{'Y': 8, 'A': 8, 'B': 4, 'D': 4, 'E': 4, 'G': 8, 'I': 4, 'K': 8, 'L': 4, 'N': 4, 'O': 4, 'U': 8, 'V': 4, 'W': 4, 'X': 4}"
INV-ZZ-0000172,SCH-ZZ-0000172,1044,Boeing 787,08/19/2024,08/19/2024,JFK,VNS,270,304,217,-53,87,27,54,81,108,32,22,10,58,24,34,88,79,9,126,92,34,"{'F': 16, 'P': 11}","{'C': 22, 'J': 16, 'Z': 16}","{'Q': 24, 'R': 16, 'S': 8, 'T': 8, 'H': 16, 'M': 8}","{'Y': 8, 'A': 8, 'B': 4, 'D': 4, 'E': 4, 'G': 8, 'I': 4, 'K': 8, 'L': 4, 'N': 4, 'O': 4, 'U': 8, 'V': 4, 'W': 4, 'X': 4}"
INV-ZZ-0000046,SCH-ZZ-0000046,1046,Boeing 787,08/19/2024,08/19/2024,JFK,DEL,270,285,224,-46,61,27,54,81,108,29,27,2,56,51,5,84,60,24,116,86,30,"{'F': 16, 'P': 11}","{'C': 22, 'J': 16, 'Z': 16}","{'Q': 24, 'R': 16, 'S': 8, 'T': 8, 'H': 16, 'M': 8}","{'Y': 8, 'A': 8, 'B': 4, 'D': 4, 'E': 4, 'G': 8, 'I': 4, 'K': 8, 'L': 4, 'N': 4, 'O': 4, 'U': 8, 'V': 4, 'W': 4, 'X': 4}"
INV-ZZ-0000110,SCH-ZZ-0000110,1046,Boeing 787,08/19/2024,08/19/2024,JFK,DEL,270,303,202,-68,101,27,54,81,108,29,25,4,58,44,14,89,76,13,127,57,70,"{'F': 16, 'P': 11}","{'C': 22, 'J': 16, 'Z': 16}","{'Q': 24, 'R': 16, 'S': 8, 'T': 8, 'H': 16, 'M': 8}","{'Y': 8, 'A': 8, 'B': 4, 'D': 4, 'E': 4, 'G': 8, 'I': 4, 'K': 8, 'L': 4, 'N': 4, 'O': 4, 'U': 8, 'V': 4, 'W': 4, 'X': 4}"
INV-ZZ-0000174,SCH-ZZ-0000174,1046,Boeing 787,08/19/2024,08/19/2024,JFK,DEL,270,285,135,-135,150,27,54,81,108,31,17,14,61,30,31,83,37,46,110,51,59,"{'F': 16, 'P': 11}","{'C': 22, 'J': 16, 'Z': 16}","{'Q': 24, 'R': 16, 'S': 8, 'T': 8, 'H': 16, 'M': 8}","{'Y': 8, 'A': 8, 'B': 4, 'D': 4, 'E': 4, 'G': 8, 'I': 4, 'K': 8, 'L': 4, 'N': 4, 'O': 4, 'U': 8, 'V': 4, 'W': 4, 'X': 4}"
INV-ZZ-0000047,SCH-ZZ-0000047,1047,Boeing 787,08/19/2024,08/19/2024,JFK,LAX,270,300,229,-41,71,27,54,81,108,31,26,5,55,52,3,91,80,11,123,71,52,"{'F': 16, 'P': 11}","{'C': 22, 'J': 16, 'Z': 16}","{'Q': 24, 'R': 16, 'S': 8, 'T': 8, 'H': 16, 'M': 8}","{'Y': 8, 'A': 8, 'B': 4, 'D': 4, 'E': 4, 'G': 8, 'I': 4, 'K': 8, 'L': 4, 'N': 4, 'O': 4, 'U': 8, 'V': 4, 'W': 4, 'X': 4}"
INV-ZZ-0000111,SCH-ZZ-0000111,1047,Boeing 787,08/19/2024,08/19/2024,JFK,LAX,270,302,181,-89,121,27,54,81,108,31,13,18,60,45,15,85,51,34,126,72,54,"{'F': 16, 'P': 11}","{'C': 22, 'J': 16, 'Z': 16}","{'Q': 24, 'R': 16, 'S': 8, 'T': 8, 'H': 16, 'M': 8}","{'Y': 8, 'A': 8, 'B': 4, 'D': 4, 'E': 4, 'G': 8, 'I': 4, 'K': 8, 'L': 4, 'N': 4, 'O': 4, 'U': 8, 'V': 4, 'W': 4, 'X': 4}"
INV-ZZ-0000175,SCH-ZZ-0000175,1047,Boeing 787,08/19/2024,08/19/2024,JFK,LAX,270,282,166,-104,116,27,54,81,108,30,23,7,57,41,16,84,51,33,111,51,60,"{'F': 16, 'P': 11}","{'C': 22, 'J': 16, 'Z': 16}","{'Q': 24, 'R': 16, 'S': 8, 'T': 8, 'H': 16, 'M': 8}","{'Y': 8, 'A': 8, 'B': 4, 'D': 4, 'E': 4, 'G': 8, 'I': 4, 'K': 8, 'L': 4, 'N': 4, 'O': 4, 'U': 8, 'V': 4, 'W': 4, 'X': 4}"
INV-ZZ-0000048,SCH-ZZ-0000048,1048,Boeing 787,08/19/2024,08/19/2024,DEL,MAA,270,282,182,-88,100,27,54,81,108,30,12,18,57,29,28,84,55,29,111,86,25,"{'F': 16, 'P': 11}","{'C': 22, 'J': 16, 'Z': 16}","{'Q': 24, 'R': 16, 'S': 8, 'T': 8, 'H': 16, 'M': 8}","{'Y': 8, 'A': 8, 'B': 4, 'D': 4, 'E': 4, 'G': 8, 'I': 4, 'K': 8, 'L': 4, 'N': 4, 'O': 4, 'U': 8, 'V': 4, 'W': 4, 'X': 4}"
INV-ZZ-0000112,SCH-ZZ-0000112,1048,Boeing 787,08/19/2024,08/19/2024,DEL,MAA,270,283,212,-58,71,27,54,81,108,28,24,4,57,21,36,82,64,18,116,103,13,"{'F': 16, 'P': 11}","{'C': 22, 'J': 16, 'Z': 16}","{'Q': 24, 'R': 16, 'S': 8, 'T': 8, 'H': 16, 'M': 8}","{'Y': 8, 'A': 8, 'B': 4, 'D': 4, 'E': 4, 'G': 8, 'I': 4, 'K': 8, 'L': 4, 'N': 4, 'O': 4, 'U': 8, 'V': 4, 'W': 4, 'X': 4}"
INV-ZZ-0000176,SCH-ZZ-0000176,1048,Boeing 787,08/19/2024,08/19/2024,DEL,MAA,270,286,195,-75,91,27,54,81,108,30,26,4,57,43,14,87,56,31,112,70,42,"{'F': 16, 'P': 11}","{'C': 22, 'J': 16, 'Z': 16}","{'Q': 24, 'R': 16, 'S': 8, 'T': 8, 'H': 16, 'M': 8}","{'Y': 8, 'A': 8, 'B': 4, 'D': 4, 'E': 4, 'G': 8, 'I': 4, 'K': 8, 'L': 4, 'N': 4, 'O': 4, 'U': 8, 'V': 4, 'W': 4, 'X': 4}"
INV-ZZ-0000049,SCH-ZZ-0000049,1049,Boeing 787,08/19/2024,08/19/2024,DEL,BLR,270,284,144,-126,140,27,54,81,108,32,21,11,60,36,24,82,35,47,110,52,58,"{'F': 16, 'P': 11}","{'C': 22, 'J': 16, 'Z': 16}","{'Q': 24, 'R': 16, 'S': 8, 'T': 8, 'H': 16, 'M': 8}","{'Y': 8, 'A': 8, 'B': 4, 'D': 4, 'E': 4, 'G': 8, 'I': 4, 'K': 8, 'L': 4, 'N': 4, 'O': 4, 'U': 8, 'V': 4, 'W': 4, 'X': 4}"
INV-ZZ-0000113,SCH-ZZ-0000113,1049,Boeing 787,08/19/2024,08/19/2024,DEL,BLR,270,285,157,-113,128,27,54,81,108,28,22,6,58,22,36,84,39,45,115,74,41,"{'F': 16, 'P': 11}","{'C': 22, 'J': 16, 'Z': 16}","{'Q': 24, 'R': 16, 'S': 8, 'T': 8, 'H': 16, 'M': 8}","{'Y': 8, 'A': 8, 'B': 4, 'D': 4, 'E': 4, 'G': 8, 'I': 4, 'K': 8, 'L': 4, 'N': 4, 'O': 4, 'U': 8, 'V': 4, 'W': 4, 'X': 4}"
INV-ZZ-0000177,SCH-ZZ-0000177,1049,Boeing 787,08/19/2024,08/19/2024,DEL,BLR,270,287,223,-47,64,27,54,81,108,31,27,4,58,39,19,87,65,22,111,92,19,"{'F': 16, 'P': 11}","{'C': 22, 'J': 16, 'Z': 16}","{'Q': 24, 'R': 16, 'S': 8, 'T': 8, 'H': 16, 'M': 8}","{'Y': 8, 'A': 8, 'B': 4, 'D': 4, 'E': 4, 'G': 8, 'I': 4, 'K': 8, 'L': 4, 'N': 4, 'O': 4, 'U': 8, 'V': 4, 'W': 4, 'X': 4}"
INV-ZZ-0000050,SCH-ZZ-0000050,1050,Boeing 787,08/19/2024,08/19/2024,DEL,BOM,270,291,128,-142,163,27,54,81,108,29,13,16,55,32,23,84,37,47,123,46,77,"{'F': 16, 'P': 11}","{'C': 22, 'J': 16, 'Z': 16}","{'Q': 24, 'R': 16, 'S': 8, 'T': 8, 'H': 16, 'M': 8}","{'Y': 8, 'A': 8, 'B': 4, 'D': 4, 'E': 4, 'G': 8, 'I': 4, 'K': 8, 'L': 4, 'N': 4, 'O': 4, 'U': 8, 'V': 4, 'W': 4, 'X': 4}"
INV-ZZ-0000114,SCH-ZZ-0000114,1050,Boeing 787,08/19/2024,08/19/2024,DEL,BOM,270,299,158,-112,141,27,54,81,108,31,26,5,58,23,35,86,41,45,124,68,56,"{'F': 16, 'P': 11}","{'C': 22, 'J': 16, 'Z': 16}","{'Q': 24, 'R': 16, 'S': 8, 'T': 8, 'H': 16, 'M': 8}","{'Y': 8, 'A': 8, 'B': 4, 'D': 4, 'E': 4, 'G': 8, 'I': 4, 'K': 8, 'L': 4, 'N': 4, 'O': 4, 'U': 8, 'V': 4, 'W': 4, 'X': 4}"
INV-ZZ-0000178,SCH-ZZ-0000178,1050,Boeing 787,08/19/2024,08/19/2024,DEL,BOM,270,296,163,-107,133,27,54,81,108,30,18,12,59,43,16,83,40,43,124,62,62,"{'F': 16, 'P': 11}","{'C': 22, 'J': 16, 'Z': 16}","{'Q': 24, 'R': 16, 'S': 8, 'T': 8, 'H': 16, 'M': 8}","{'Y': 8, 'A': 8, 'B': 4, 'D': 4, 'E': 4, 'G': 8, 'I': 4, 'K': 8, 'L': 4, 'N': 4, 'O': 4, 'U': 8, 'V': 4, 'W': 4, 'X': 4}"
INV-ZZ-0000051,SCH-ZZ-0000051,1051,Boeing 787,08/19/2024,08/19/2024,DEL,DUB,270,294,221,-49,73,27,54,81,108,32,22,10,59,51,8,89,47,42,114,101,13,"{'F': 16, 'P': 11}","{'C': 22, 'J': 16, 'Z': 16}","{'Q': 24, 'R': 16, 'S': 8, 'T': 8, 'H': 16, 'M': 8}","{'Y': 8, 'A': 8, 'B': 4, 'D': 4, 'E': 4, 'G': 8, 'I': 4, 'K': 8, 'L': 4, 'N': 4, 'O': 4, 'U': 8, 'V': 4, 'W': 4, 'X': 4}"
INV-ZZ-0000115,SCH-ZZ-0000115,1051,Boeing 787,08/19/2024,08/19/2024,DEL,DUB,270,298,215,-55,83,27,54,81,108,32,11,21,61,43,18,89,73,16,116,88,28,"{'F': 16, 'P': 11}","{'C': 22, 'J': 16, 'Z': 16}","{'Q': 24, 'R': 16, 'S': 8, 'T': 8, 'H': 16, 'M': 8}","{'Y': 8, 'A': 8, 'B': 4, 'D': 4, 'E': 4, 'G': 8, 'I': 4, 'K': 8, 'L': 4, 'N': 4, 'O': 4, 'U': 8, 'V': 4, 'W': 4, 'X': 4}"
INV-ZZ-0000179,SCH-ZZ-0000179,1051,Boeing 787,08/19/2024,08/19/2024,DEL,DUB,270,304,214,-56,90,27,54,81,108,29,20,9,57,30,27,91,58,33,127,106,21,"{'F': 16, 'P': 11}","{'C': 22, 'J': 16, 'Z': 16}","{'Q': 24, 'R': 16, 'S': 8, 'T': 8, 'H': 16, 'M': 8}","{'Y': 8, 'A': 8, 'B': 4, 'D': 4, 'E': 4, 'G': 8, 'I': 4, 'K': 8, 'L': 4, 'N': 4, 'O': 4, 'U': 8, 'V': 4, 'W': 4, 'X': 4}"
INV-ZZ-0000052,SCH-ZZ-0000052,1052,Boeing 787,08/19/2024,08/19/2024,DEL,VNS,270,297,184,-86,113,27,54,81,108,29,11,18,57,43,14,85,47,38,126,83,43,"{'F': 16, 'P': 11}","{'C': 22, 'J': 16, 'Z': 16}","{'Q': 24, 'R': 16, 'S': 8, 'T': 8, 'H': 16, 'M': 8}","{'Y': 8, 'A': 8, 'B': 4, 'D': 4, 'E': 4, 'G': 8, 'I': 4, 'K': 8, 'L': 4, 'N': 4, 'O': 4, 'U': 8, 'V': 4, 'W': 4, 'X': 4}"
INV-ZZ-0000116,SCH-ZZ-0000116,1052,Boeing 787,08/19/2024,08/19/2024,DEL,VNS,270,299,179,-91,120,27,54,81,108,28,26,2,55,23,32,89,52,37,127,78,49,"{'F': 16, 'P': 11}","{'C': 22, 'J': 16, 'Z': 16}","{'Q': 24, 'R': 16, 'S': 8, 'T': 8, 'H': 16, 'M': 8}","{'Y': 8, 'A': 8, 'B': 4, 'D': 4, 'E': 4, 'G': 8, 'I': 4, 'K': 8, 'L': 4, 'N': 4, 'O': 4, 'U': 8, 'V': 4, 'W': 4, 'X': 4}"
INV-ZZ-0000180,SCH-ZZ-0000180,1052,Boeing 787,08/19/2024,08/19/2024,DEL,VNS,270,286,203,-67,83,27,54,81,108,32,18,14,60,46,14,82,48,34,112,91,21,"{'F': 16, 'P': 11}","{'C': 22, 'J': 16, 'Z': 16}","{'Q': 24, 'R': 16, 'S': 8, 'T': 8, 'H': 16, 'M': 8}","{'Y': 8, 'A': 8, 'B': 4, 'D': 4, 'E': 4, 'G': 8, 'I': 4, 'K': 8, 'L': 4, 'N': 4, 'O': 4, 'U': 8, 'V': 4, 'W': 4, 'X': 4}"
INV-ZZ-0000053,SCH-ZZ-0000053,1053,Boeing 787,08/19/2024,08/19/2024,DEL,JFK,270,300,168,-102,132,27,54,81,108,32,23,9,59,28,31,90,43,47,119,74,45,"{'F': 16, 'P': 11}","{'C': 22, 'J': 16, 'Z': 16}","{'Q': 24, 'R': 16, 'S': 8, 'T': 8, 'H': 16, 'M': 8}","{'Y': 8, 'A': 8, 'B': 4, 'D': 4, 'E': 4, 'G': 8, 'I': 4, 'K': 8, 'L': 4, 'N': 4, 'O': 4, 'U': 8, 'V': 4, 'W': 4, 'X': 4}"
INV-ZZ-0000117,SCH-ZZ-0000117,1053,Boeing 787,08/19/2024,08/19/2024,DEL,JFK,270,295,214,-56,81,27,54,81,108,32,14,18,59,44,15,91,71,20,113,85,28,"{'F': 16, 'P': 11}","{'C': 22, 'J': 16, 'Z': 16}","{'Q': 24, 'R': 16, 'S': 8, 'T': 8, 'H': 16, 'M': 8}","{'Y': 8, 'A': 8, 'B': 4, 'D': 4, 'E': 4, 'G': 8, 'I': 4, 'K': 8, 'L': 4, 'N': 4, 'O': 4, 'U': 8, 'V': 4, 'W': 4, 'X': 4}"
INV-ZZ-0000181,SCH-ZZ-0000181,1053,Boeing 787,08/19/2024,08/19/2024,DEL,JFK,270,305,236,-34,69,27,54,81,108,32,23,9,60,47,13,89,62,27,124,104,20,"{'F': 16, 'P': 11}","{'C': 22, 'J': 16, 'Z': 16}","{'Q': 24, 'R': 16, 'S': 8, 'T': 8, 'H': 16, 'M': 8}","{'Y': 8, 'A': 8, 'B': 4, 'D': 4, 'E': 4, 'G': 8, 'I': 4, 'K': 8, 'L': 4, 'N': 4, 'O': 4, 'U': 8, 'V': 4, 'W': 4, 'X': 4}"
INV-ZZ-0000055,SCH-ZZ-0000055,1055,Boeing 787,08/19/2024,08/19/2024,DEL,LAX,270,288,176,-94,112,27,54,81,108,28,22,6,60,46,14,85,51,34,115,57,58,"{'F': 16, 'P': 11}","{'C': 22, 'J': 16, 'Z': 16}","{'Q': 24, 'R': 16, 'S': 8, 'T': 8, 'H': 16, 'M': 8}","{'Y': 8, 'A': 8, 'B': 4, 'D': 4, 'E': 4, 'G': 8, 'I': 4, 'K': 8, 'L': 4, 'N': 4, 'O': 4, 'U': 8, 'V': 4, 'W': 4, 'X': 4}"
INV-ZZ-0000119,SCH-ZZ-0000119,1055,Boeing 787,08/19/2024,08/19/2024,DEL,LAX,270,290,158,-112,132,27,54,81,108,31,23,8,56,32,24,86,44,42,117,59,58,"{'F': 16, 'P': 11}","{'C': 22, 'J': 16, 'Z': 16}","{'Q': 24, 'R': 16, 'S': 8, 'T': 8, 'H': 16, 'M': 8}","{'Y': 8, 'A': 8, 'B': 4, 'D': 4, 'E': 4, 'G': 8, 'I': 4, 'K': 8, 'L': 4, 'N': 4, 'O': 4, 'U': 8, 'V': 4, 'W': 4, 'X': 4}"
INV-ZZ-0000183,SCH-ZZ-0000183,1055,Boeing 787,08/19/2024,08/19/2024,DEL,LAX,270,305,225,-45,80,27,54,81,108,28,22,6,60,38,22,89,57,32,128,108,20,"{'F': 16, 'P': 11}","{'C': 22, 'J': 16, 'Z': 16}","{'Q': 24, 'R': 16, 'S': 8, 'T': 8, 'H': 16, 'M': 8}","{'Y': 8, 'A': 8, 'B': 4, 'D': 4, 'E': 4, 'G': 8, 'I': 4, 'K': 8, 'L': 4, 'N': 4, 'O': 4, 'U': 8, 'V': 4, 'W': 4, 'X': 4}"
INV-ZZ-0000056,SCH-ZZ-0000056,1056,Boeing 787,08/19/2024,08/19/2024,LAX,MAA,270,287,181,-89,106,27,54,81,108,32,21,11,59,38,21,85,65,20,111,57,54,"{'F': 16, 'P': 11}","{'C': 22, 'J': 16, 'Z': 16}","{'Q': 24, 'R': 16, 'S': 8, 'T': 8, 'H': 16, 'M': 8}","{'Y': 8, 'A': 8, 'B': 4, 'D': 4, 'E': 4, 'G': 8, 'I': 4, 'K': 8, 'L': 4, 'N': 4, 'O': 4, 'U': 8, 'V': 4, 'W': 4, 'X': 4}"
INV-ZZ-0000120,SCH-ZZ-0000120,1056,Boeing 787,08/19/2024,08/19/2024,LAX,MAA,270,302,180,-90,122,27,54,81,108,31,15,16,55,48,7,88,39,49,128,78,50,"{'F': 16, 'P': 11}","{'C': 22, 'J': 16, 'Z': 16}","{'Q': 24, 'R': 16, 'S': 8, 'T': 8, 'H': 16, 'M': 8}","{'Y': 8, 'A': 8, 'B': 4, 'D': 4, 'E': 4, 'G': 8, 'I': 4, 'K': 8, 'L': 4, 'N': 4, 'O': 4, 'U': 8, 'V': 4, 'W': 4, 'X': 4}"
INV-ZZ-0000184,SCH-ZZ-0000184,1056,Boeing 787,08/19/2024,08/19/2024,LAX,MAA,270,287,201,-69,86,27,54,81,108,31,19,12,55,37,18,87,46,41,114,99,15,"{'F': 16, 'P': 11}","{'C': 22, 'J': 16, 'Z': 16}","{'Q': 24, 'R': 16, 'S': 8, 'T': 8, 'H': 16, 'M': 8}","{'Y': 8, 'A': 8, 'B': 4, 'D': 4, 'E': 4, 'G': 8, 'I': 4, 'K': 8, 'L': 4, 'N': 4, 'O': 4, 'U': 8, 'V': 4, 'W': 4, 'X': 4}"
INV-ZZ-0000057,SCH-ZZ-0000057,1057,Boeing 787,08/19/2024,08/19/2024,LAX,BLR,270,282,197,-73,85,27,54,81,108,31,16,15,55,38,17,82,63,19,114,80,34,"{'F': 16, 'P': 11}","{'C': 22, 'J': 16, 'Z': 16}","{'Q': 24, 'R': 16, 'S': 8, 'T': 8, 'H': 16, 'M': 8}","{'Y': 8, 'A': 8, 'B': 4, 'D': 4, 'E': 4, 'G': 8, 'I': 4, 'K': 8, 'L': 4, 'N': 4, 'O': 4, 'U': 8, 'V': 4, 'W': 4, 'X': 4}"
INV-ZZ-0000121,SCH-ZZ-0000121,1057,Boeing 787,08/19/2024,08/19/2024,LAX,BLR,270,286,193,-77,93,27,54,81,108,31,24,7,59,21,38,85,76,9,111,72,39,"{'F': 16, 'P': 11}","{'C': 22, 'J': 16, 'Z': 16}","{'Q': 24, 'R': 16, 'S': 8, 'T': 8, 'H': 16, 'M': 8}","{'Y': 8, 'A': 8, 'B': 4, 'D': 4, 'E': 4, 'G': 8, 'I': 4, 'K': 8, 'L': 4, 'N': 4, 'O': 4, 'U': 8, 'V': 4, 'W': 4, 'X': 4}"
INV-ZZ-0000185,SCH-ZZ-0000185,1057,Boeing 787,08/19/2024,08/19/2024,LAX,BLR,270,295,204,-66,91,27,54,81,108,28,25,3,59,52,7,85,64,21,123,63,60,"{'F': 16, 'P': 11}","{'C': 22, 'J': 16, 'Z': 16}","{'Q': 24, 'R': 16, 'S': 8, 'T': 8, 'H': 16, 'M': 8}","{'Y': 8, 'A': 8, 'B': 4, 'D': 4, 'E': 4, 'G': 8, 'I': 4, 'K': 8, 'L': 4, 'N': 4, 'O': 4, 'U': 8, 'V': 4, 'W': 4, 'X': 4}"
INV-ZZ-0000058,SCH-ZZ-0000058,1058,Boeing 787,08/19/2024,08/19/2024,LAX,BOM,270,294,222,-48,72,27,54,81,108,32,15,17,60,40,20,90,61,29,112,106,6,"{'F': 16, 'P': 11}","{'C': 22, 'J': 16, 'Z': 16}","{'Q': 24, 'R': 16, 'S': 8, 'T': 8, 'H': 16, 'M': 8}","{'Y': 8, 'A': 8, 'B': 4, 'D': 4, 'E': 4, 'G': 8, 'I': 4, 'K': 8, 'L': 4, 'N': 4, 'O': 4, 'U': 8, 'V': 4, 'W': 4, 'X': 4}"
INV-ZZ-0000122,SCH-ZZ-0000122,1058,Boeing 787,08/19/2024,08/19/2024,LAX,BOM,270,293,166,-104,127,27,54,81,108,32,25,7,56,30,26,86,55,31,119,56,63,"{'F': 16, 'P': 11}","{'C': 22, 'J': 16, 'Z': 16}","{'Q': 24, 'R': 16, 'S': 8, 'T': 8, 'H': 16, 'M': 8}","{'Y': 8, 'A': 8, 'B': 4, 'D': 4, 'E': 4, 'G': 8, 'I': 4, 'K': 8, 'L': 4, 'N': 4, 'O': 4, 'U': 8, 'V': 4, 'W': 4, 'X': 4}"
INV-ZZ-0000186,SCH-ZZ-0000186,1058,Boeing 787,08/19/2024,08/19/2024,LAX,BOM,270,288,160,-110,128,27,54,81,108,28,27,1,57,22,35,87,55,32,116,56,60,"{'F': 16, 'P': 11}","{'C': 22, 'J': 16, 'Z': 16}","{'Q': 24, 'R': 16, 'S': 8, 'T': 8, 'H': 16, 'M': 8}","{'Y': 8, 'A': 8, 'B': 4, 'D': 4, 'E': 4, 'G': 8, 'I': 4, 'K': 8, 'L': 4, 'N': 4, 'O': 4, 'U': 8, 'V': 4, 'W': 4, 'X': 4}"
INV-ZZ-0000059,SCH-ZZ-0000059,1059,Boeing 787,08/19/2024,08/19/2024,LAX,DUB,270,301,218,-52,83,27,54,81,108,29,23,6,61,21,40,89,68,21,122,106,16,"{'F': 16, 'P': 11}","{'C': 22, 'J': 16, 'Z': 16}","{'Q': 24, 'R': 16, 'S': 8, 'T': 8, 'H': 16, 'M': 8}","{'Y': 8, 'A': 8, 'B': 4, 'D': 4, 'E': 4, 'G': 8, 'I': 4, 'K': 8, 'L': 4, 'N': 4, 'O': 4, 'U': 8, 'V': 4, 'W': 4, 'X': 4}"
INV-ZZ-0000123,SCH-ZZ-0000123,1059,Boeing 787,08/19/2024,08/19/2024,LAX,DUB,270,289,162,-108,127,27,54,81,108,30,14,16,56,43,13,82,62,20,121,43,78,"{'F': 16, 'P': 11}","{'C': 22, 'J': 16, 'Z': 16}","{'Q': 24, 'R': 16, 'S': 8, 'T': 8, 'H': 16, 'M': 8}","{'Y': 8, 'A': 8, 'B': 4, 'D': 4, 'E': 4, 'G': 8, 'I': 4, 'K': 8, 'L': 4, 'N': 4, 'O': 4, 'U': 8, 'V': 4, 'W': 4, 'X': 4}"
INV-ZZ-0000187,SCH-ZZ-0000187,1059,Boeing 787,08/19/2024,08/19/2024,LAX,DUB,270,302,199,-71,103,27,54,81,108,32,22,10,61,43,18,84,50,34,125,84,41,"{'F': 16, 'P': 11}","{'C': 22, 'J': 16, 'Z': 16}","{'Q': 24, 'R': 16, 'S': 8, 'T': 8, 'H': 16, 'M': 8}","{'Y': 8, 'A': 8, 'B': 4, 'D': 4, 'E': 4, 'G': 8, 'I': 4, 'K': 8, 'L': 4, 'N': 4, 'O': 4, 'U': 8, 'V': 4, 'W': 4, 'X': 4}"
INV-ZZ-0000060,SCH-ZZ-0000060,1060,Boeing 787,08/19/2024,08/19/2024,LAX,VNS,270,287,210,-60,77,27,54,81,108,29,12,17,55,22,33,82,81,1,121,95,26,"{'F': 16, 'P': 11}","{'C': 22, 'J': 16, 'Z': 16}","{'Q': 24, 'R': 16, 'S': 8, 'T': 8, 'H': 16, 'M': 8}","{'Y': 8, 'A': 8, 'B': 4, 'D': 4, 'E': 4, 'G': 8, 'I': 4, 'K': 8, 'L': 4, 'N': 4, 'O': 4, 'U': 8, 'V': 4, 'W': 4, 'X': 4}"
INV-ZZ-0000124,SCH-ZZ-0000124,1060,Boeing 787,08/19/2024,08/19/2024,LAX,VNS,270,294,226,-44,68,27,54,81,108,30,13,17,58,35,23,86,73,13,120,105,15,"{'F': 16, 'P': 11}","{'C': 22, 'J': 16, 'Z': 16}","{'Q': 24, 'R': 16, 'S': 8, 'T': 8, 'H': 16, 'M': 8}","{'Y': 8, 'A': 8, 'B': 4, 'D': 4, 'E': 4, 'G': 8, 'I': 4, 'K': 8, 'L': 4, 'N': 4, 'O': 4, 'U': 8, 'V': 4, 'W': 4, 'X': 4}"
INV-ZZ-0000188,SCH-ZZ-0000188,1060,Boeing 787,08/19/2024,08/19/2024,LAX,VNS,270,285,178,-92,107,27,54,81,108,30,15,15,60,28,32,83,54,29,112,81,31,"{'F': 16, 'P': 11}","{'C': 22, 'J': 16, 'Z': 16}","{'Q': 24, 'R': 16, 'S': 8, 'T': 8, 'H': 16, 'M': 8}","{'Y': 8, 'A': 8, 'B': 4, 'D': 4, 'E': 4, 'G': 8, 'I': 4, 'K': 8, 'L': 4, 'N': 4, 'O': 4, 'U': 8, 'V': 4, 'W': 4, 'X': 4}"
INV-ZZ-0000061,SCH-ZZ-0000061,1061,Boeing 787,08/19/2024,08/19/2024,LAX,JFK,270,281,184,-86,97,27,54,81,108,32,10,22,55,24,31,83,76,7,111,74,37,"{'F': 16, 'P': 11}","{'C': 22, 'J': 16, 'Z': 16}","{'Q': 24, 'R': 16, 'S': 8, 'T': 8, 'H': 16, 'M': 8}","{'Y': 8, 'A': 8, 'B': 4, 'D': 4, 'E': 4, 'G': 8, 'I': 4, 'K': 8, 'L': 4, 'N': 4, 'O': 4, 'U': 8, 'V': 4, 'W': 4, 'X': 4}"
INV-ZZ-0000125,SCH-ZZ-0000125,1061,Boeing 787,08/19/2024,08/19/2024,LAX,JFK,270,305,214,-56,91,27,54,81,108,29,22,7,60,46,14,91,78,13,125,68,57,"{'F': 16, 'P': 11}","{'C': 22, 'J': 16, 'Z': 16}","{'Q': 24, 'R': 16, 'S': 8, 'T': 8, 'H': 16, 'M': 8}","{'Y': 8, 'A': 8, 'B': 4, 'D': 4, 'E': 4, 'G': 8, 'I': 4, 'K': 8, 'L': 4, 'N': 4, 'O': 4, 'U': 8, 'V': 4, 'W': 4, 'X': 4}"
INV-ZZ-0000189,SCH-ZZ-0000189,1061,Boeing 787,08/19/2024,08/19/2024,LAX,JFK,270,302,157,-113,145,27,54,81,108,29,15,14,58,32,26,88,62,26,127,48,79,"{'F': 16, 'P': 11}","{'C': 22, 'J': 16, 'Z': 16}","{'Q': 24, 'R': 16, 'S': 8, 'T': 8, 'H': 16, 'M': 8}","{'Y': 8, 'A': 8, 'B': 4, 'D': 4, 'E': 4, 'G': 8, 'I': 4, 'K': 8, 'L': 4, 'N': 4, 'O': 4, 'U': 8, 'V': 4, 'W': 4, 'X': 4}"
INV-ZZ-0000062,SCH-ZZ-0000062,1062,Boeing 787,08/19/2024,08/19/2024,LAX,DEL,270,300,220,-50,80,27,54,81,108,32,27,5,61,44,17,86,72,14,121,77,44,"{'F': 16, 'P': 11}","{'C': 22, 'J': 16, 'Z': 16}","{'Q': 24, 'R': 16, 'S': 8, 'T': 8, 'H': 16, 'M': 8}","{'Y': 8, 'A': 8, 'B': 4, 'D': 4, 'E': 4, 'G': 8, 'I': 4, 'K': 8, 'L': 4, 'N': 4, 'O': 4, 'U': 8, 'V': 4, 'W': 4, 'X': 4}"
INV-ZZ-0000126,SCH-ZZ-0000126,1062,Boeing 787,08/19/2024,08/19/2024,LAX,DEL,270,300,172,-98,128,27,54,81,108,30,26,4,61,36,25,87,60,27,122,50,72,"{'F': 16, 'P': 11}","{'C': 22, 'J': 16, 'Z': 16}","{'Q': 24, 'R': 16, 'S': 8, 'T': 8, 'H': 16, 'M': 8}","{'Y': 8, 'A': 8, 'B': 4, 'D': 4, 'E': 4, 'G': 8, 'I': 4, 'K': 8, 'L': 4, 'N': 4, 'O': 4, 'U': 8, 'V': 4, 'W': 4, 'X': 4}"
INV-ZZ-0000190,SCH-ZZ-0000190,1062,Boeing 787,08/19/2024,08/19/2024,LAX,DEL,270,296,191,-79,105,27,54,81,108,30,21,9,59,23,36,82,43,39,125,104,21,"{'F': 16, 'P': 11}","{'C': 22, 'J': 16, 'Z': 16}","{'Q': 24, 'R': 16, 'S': 8, 'T': 8, 'H': 16, 'M': 8}","{'Y': 8, 'A': 8, 'B': 4, 'D': 4, 'E': 4, 'G': 8, 'I': 4, 'K': 8, 'L': 4, 'N': 4, 'O': 4, 'U': 8, 'V': 4, 'W': 4, 'X': 4}"
INV-ZZ-0000197,SCH-ZZ-0000001,1001,Boeing 787,08/20/2024,08/20/2024,MAA,BLR,270,291,154,-116,137,27,54,81,108,32,10,22,59,41,18,82,50,32,118,53,65,"{'F': 16, 'P': 11}","{'C': 22, 'J': 16, 'Z': 16}","{'Q': 24, 'R': 16, 'S': 8, 'T': 8, 'H': 16, 'M': 8}","{'Y': 8, 'A': 8, 'B': 4, 'D': 4, 'E': 4, 'G': 8, 'I': 4, 'K': 8, 'L': 4, 'N': 4, 'O': 4, 'U': 8, 'V': 4, 'W': 4, 'X': 4}"
INV-ZZ-0000261,SCH-ZZ-0000065,1001,Boeing 787,08/20/2024,08/20/2024,MAA,BLR,270,300,214,-56,86,27,54,81,108,31,27,4,60,50,10,89,61,28,120,76,44,"{'F': 16, 'P': 11}","{'C': 22, 'J': 16, 'Z': 16}","{'Q': 24, 'R': 16, 'S': 8, 'T': 8, 'H': 16, 'M': 8}","{'Y': 8, 'A': 8, 'B': 4, 'D': 4, 'E': 4, 'G': 8, 'I': 4, 'K': 8, 'L': 4, 'N': 4, 'O': 4, 'U': 8, 'V': 4, 'W': 4, 'X': 4}"
INV-ZZ-0000325,SCH-ZZ-0000129,1001,Boeing 787,08/20/2024,08/20/2024,MAA,BLR,270,292,213,-57,79,27,54,81,108,31,13,18,59,38,21,87,79,8,115,83,32,"{'F': 16, 'P': 11}","{'C': 22, 'J': 16, 'Z': 16}","{'Q': 24, 'R': 16, 'S': 8, 'T': 8, 'H': 16, 'M': 8}","{'Y': 8, 'A': 8, 'B': 4, 'D': 4, 'E': 4, 'G': 8, 'I': 4, 'K': 8, 'L': 4, 'N': 4, 'O': 4, 'U': 8, 'V': 4, 'W': 4, 'X': 4}"
INV-ZZ-0000198,SCH-ZZ-0000002,1002,Boeing 787,08/20/2024,08/20/2024,MAA,BOM,270,288,209,-61,79,27,54,81,108,32,19,13,60,36,24,87,53,34,109,101,8,"{'F': 16, 'P': 11}","{'C': 22, 'J': 16, 'Z': 16}","{'Q': 24, 'R': 16, 'S': 8, 'T': 8, 'H': 16, 'M': 8}","{'Y': 8, 'A': 8, 'B': 4, 'D': 4, 'E': 4, 'G': 8, 'I': 4, 'K': 8, 'L': 4, 'N': 4, 'O': 4, 'U': 8, 'V': 4, 'W': 4, 'X': 4}"
INV-ZZ-0000262,SCH-ZZ-0000066,1002,Boeing 787,08/20/2024,08/20/2024,MAA,BOM,270,282,149,-121,133,27,54,81,108,29,12,17,55,34,21,89,40,49,109,63,46,"{'F': 16, 'P': 11}","{'C': 22, 'J': 16, 'Z': 16}","{'Q': 24, 'R': 16, 'S': 8, 'T': 8, 'H': 16, 'M': 8}","{'Y': 8, 'A': 8, 'B': 4, 'D': 4, 'E': 4, 'G': 8, 'I': 4, 'K': 8, 'L': 4, 'N': 4, 'O': 4, 'U': 8, 'V': 4, 'W': 4, 'X': 4}"
INV-ZZ-0000326,SCH-ZZ-0000130,1002,Boeing 787,08/20/2024,08/20/2024,MAA,BOM,270,297,162,-108,135,27,54,81,108,28,16,12,59,20,39,85,52,33,125,74,51,"{'F': 16, 'P': 11}","{'C': 22, 'J': 16, 'Z': 16}","{'Q': 24, 'R': 16, 'S': 8, 'T': 8, 'H': 16, 'M': 8}","{'Y': 8, 'A': 8, 'B': 4, 'D': 4, 'E': 4, 'G': 8, 'I': 4, 'K': 8, 'L': 4, 'N': 4, 'O': 4, 'U': 8, 'V': 4, 'W': 4, 'X': 4}"
INV-ZZ-0000199,SCH-ZZ-0000003,1003,Boeing 787,08/20/2024,08/20/2024,MAA,DUB,270,295,158,-112,137,27,54,81,108,32,14,18,61,22,39,83,45,38,119,77,42,"{'F': 16, 'P': 11}","{'C': 22, 'J': 16, 'Z': 16}","{'Q': 24, 'R': 16, 'S': 8, 'T': 8, 'H': 16, 'M': 8}","{'Y': 8, 'A': 8, 'B': 4, 'D': 4, 'E': 4, 'G': 8, 'I': 4, 'K': 8, 'L': 4, 'N': 4, 'O': 4, 'U': 8, 'V': 4, 'W': 4, 'X': 4}"
INV-ZZ-0000263,SCH-ZZ-0000067,1003,Boeing 787,08/20/2024,08/20/2024,MAA,DUB,270,291,147,-123,144,27,54,81,108,28,14,14,60,27,33,86,58,28,117,48,69,"{'F': 16, 'P': 11}","{'C': 22, 'J': 16, 'Z': 16}","{'Q': 24, 'R': 16, 'S': 8, 'T': 8, 'H': 16, 'M': 8}","{'Y': 8, 'A': 8, 'B': 4, 'D': 4, 'E': 4, 'G': 8, 'I': 4, 'K': 8, 'L': 4, 'N': 4, 'O': 4, 'U': 8, 'V': 4, 'W': 4, 'X': 4}"
INV-ZZ-0000327,SCH-ZZ-0000131,1003,Boeing 787,08/20/2024,08/20/2024,MAA,DUB,270,288,140,-130,148,27,54,81,108,32,12,20,56,26,30,91,62,29,109,40,69,"{'F': 16, 'P': 11}","{'C': 22, 'J': 16, 'Z': 16}","{'Q': 24, 'R': 16, 'S': 8, 'T': 8, 'H': 16, 'M': 8}","{'Y': 8, 'A': 8, 'B': 4, 'D': 4, 'E': 4, 'G': 8, 'I': 4, 'K': 8, 'L': 4, 'N': 4, 'O': 4, 'U': 8, 'V': 4, 'W': 4, 'X': 4}"
INV-ZZ-0000200,SCH-ZZ-0000004,1004,Boeing 787,08/20/2024,08/20/2024,MAA,VNS,270,290,193,-77,97,27,54,81,108,28,26,2,59,33,26,83,60,23,120,74,46,"{'F': 16, 'P': 11}","{'C': 22, 'J': 16, 'Z': 16}","{'Q': 24, 'R': 16, 'S': 8, 'T': 8, 'H': 16, 'M': 8}","{'Y': 8, 'A': 8, 'B': 4, 'D': 4, 'E': 4, 'G': 8, 'I': 4, 'K': 8, 'L': 4, 'N': 4, 'O': 4, 'U': 8, 'V': 4, 'W': 4, 'X': 4}"
INV-ZZ-0000264,SCH-ZZ-0000068,1004,Boeing 787,08/20/2024,08/20/2024,MAA,VNS,270,284,234,-36,50,27,54,81,108,31,11,20,56,52,4,87,70,17,110,101,9,"{'F': 16, 'P': 11}","{'C': 22, 'J': 16, 'Z': 16}","{'Q': 24, 'R': 16, 'S': 8, 'T': 8, 'H': 16, 'M': 8}","{'Y': 8, 'A': 8, 'B': 4, 'D': 4, 'E': 4, 'G': 8, 'I': 4, 'K': 8, 'L': 4, 'N': 4, 'O': 4, 'U': 8, 'V': 4, 'W': 4, 'X': 4}"
INV-ZZ-0000328,SCH-ZZ-0000132,1004,Boeing 787,08/20/2024,08/20/2024,MAA,VNS,270,286,169,-101,117,27,54,81,108,28,17,11,59,21,38,89,44,45,110,87,23,"{'F': 16, 'P': 11}","{'C': 22, 'J': 16, 'Z': 16}","{'Q': 24, 'R': 16, 'S': 8, 'T': 8, 'H': 16, 'M': 8}","{'Y': 8, 'A': 8, 'B': 4, 'D': 4, 'E': 4, 'G': 8, 'I': 4, 'K': 8, 'L': 4, 'N': 4, 'O': 4, 'U': 8, 'V': 4, 'W': 4, 'X': 4}"
INV-ZZ-0000201,SCH-ZZ-0000005,1005,Boeing 787,08/20/2024,08/20/2024,MAA,JFK,270,291,222,-48,69,27,54,81,108,29,23,6,55,49,6,90,53,37,117,97,20,"{'F': 16, 'P': 11}","{'C': 22, 'J': 16, 'Z': 16}","{'Q': 24, 'R': 16, 'S': 8, 'T': 8, 'H': 16, 'M': 8}","{'Y': 8, 'A': 8, 'B': 4, 'D': 4, 'E': 4, 'G': 8, 'I': 4, 'K': 8, 'L': 4, 'N': 4, 'O': 4, 'U': 8, 'V': 4, 'W': 4, 'X': 4}"
INV-ZZ-0000265,SCH-ZZ-0000069,1005,Boeing 787,08/20/2024,08/20/2024,MAA,JFK,270,286,194,-76,92,27,54,81,108,30,22,8,57,31,26,83,80,3,116,61,55,"{'F': 16, 'P': 11}","{'C': 22, 'J': 16, 'Z': 16}","{'Q': 24, 'R': 16, 'S': 8, 'T': 8, 'H': 16, 'M': 8}","{'Y': 8, 'A': 8, 'B': 4, 'D': 4, 'E': 4, 'G': 8, 'I': 4, 'K': 8, 'L': 4, 'N': 4, 'O': 4, 'U': 8, 'V': 4, 'W': 4, 'X': 4}"
INV-ZZ-0000329,SCH-ZZ-0000133,1005,Boeing 787,08/20/2024,08/20/2024,MAA,JFK,270,283,169,-101,114,27,54,81,108,30,15,15,57,30,27,84,35,49,112,89,23,"{'F': 16, 'P': 11}","{'C': 22, 'J': 16, 'Z': 16}","{'Q': 24, 'R': 16, 'S': 8, 'T': 8, 'H': 16, 'M': 8}","{'Y': 8, 'A': 8, 'B': 4, 'D': 4, 'E': 4, 'G': 8, 'I': 4, 'K': 8, 'L': 4, 'N': 4, 'O': 4, 'U': 8, 'V': 4, 'W': 4, 'X': 4}"
INV-ZZ-0000202,SCH-ZZ-0000006,1006,Boeing 787,08/20/2024,08/20/2024,MAA,DEL,270,283,162,-108,121,27,54,81,108,30,24,6,57,20,37,83,68,15,113,50,63,"{'F': 16, 'P': 11}","{'C': 22, 'J': 16, 'Z': 16}","{'Q': 24, 'R': 16, 'S': 8, 'T': 8, 'H': 16, 'M': 8}","{'Y': 8, 'A': 8, 'B': 4, 'D': 4, 'E': 4, 'G': 8, 'I': 4, 'K': 8, 'L': 4, 'N': 4, 'O': 4, 'U': 8, 'V': 4, 'W': 4, 'X': 4}"
INV-ZZ-0000266,SCH-ZZ-0000070,1006,Boeing 787,08/20/2024,08/20/2024,MAA,DEL,270,291,207,-63,84,27,54,81,108,31,13,18,58,52,6,83,71,12,119,71,48,"{'F': 16, 'P': 11}","{'C': 22, 'J': 16, 'Z': 16}","{'Q': 24, 'R': 16, 'S': 8, 'T': 8, 'H': 16, 'M': 8}","{'Y': 8, 'A': 8, 'B': 4, 'D': 4, 'E': 4, 'G': 8, 'I': 4, 'K': 8, 'L': 4, 'N': 4, 'O': 4, 'U': 8, 'V': 4, 'W': 4, 'X': 4}"
INV-ZZ-0000330,SCH-ZZ-0000134,1006,Boeing 787,08/20/2024,08/20/2024,MAA,DEL,270,295,231,-39,64,27,54,81,108,29,20,9,56,38,18,89,67,22,121,106,15,"{'F': 16, 'P': 11}","{'C': 22, 'J': 16, 'Z': 16}","{'Q': 24, 'R': 16, 'S': 8, 'T': 8, 'H': 16, 'M': 8}","{'Y': 8, 'A': 8, 'B': 4, 'D': 4, 'E': 4, 'G': 8, 'I': 4, 'K': 8, 'L': 4, 'N': 4, 'O': 4, 'U': 8, 'V': 4, 'W': 4, 'X': 4}"
INV-ZZ-0000203,SCH-ZZ-0000007,1007,Boeing 787,08/20/2024,08/20/2024,MAA,LAX,270,297,172,-98,125,27,54,81,108,29,15,14,59,38,21,91,50,41,118,69,49,"{'F': 16, 'P': 11}","{'C': 22, 'J': 16, 'Z': 16}","{'Q': 24, 'R': 16, 'S': 8, 'T': 8, 'H': 16, 'M': 8}","{'Y': 8, 'A': 8, 'B': 4, 'D': 4, 'E': 4, 'G': 8, 'I': 4, 'K': 8, 'L': 4, 'N': 4, 'O': 4, 'U': 8, 'V': 4, 'W': 4, 'X': 4}"
INV-ZZ-0000267,SCH-ZZ-0000071,1007,Boeing 787,08/20/2024,08/20/2024,MAA,LAX,270,293,240,-30,53,27,54,81,108,28,26,2,57,50,7,82,56,26,126,108,18,"{'F': 16, 'P': 11}","{'C': 22, 'J': 16, 'Z': 16}","{'Q': 24, 'R': 16, 'S': 8, 'T': 8, 'H': 16, 'M': 8}","{'Y': 8, 'A': 8, 'B': 4, 'D': 4, 'E': 4, 'G': 8, 'I': 4, 'K': 8, 'L': 4, 'N': 4, 'O': 4, 'U': 8, 'V': 4, 'W': 4, 'X': 4}"
INV-ZZ-0000331,SCH-ZZ-0000135,1007,Boeing 787,08/20/2024,08/20/2024,MAA,LAX,270,291,206,-64,85,27,54,81,108,32,10,22,61,46,15,83,71,12,115,79,36,"{'F': 16, 'P': 11}","{'C': 22, 'J': 16, 'Z': 16}","{'Q': 24, 'R': 16, 'S': 8, 'T': 8, 'H': 16, 'M': 8}","{'Y': 8, 'A': 8, 'B': 4, 'D': 4, 'E': 4, 'G': 8, 'I': 4, 'K': 8, 'L': 4, 'N': 4, 'O': 4, 'U': 8, 'V': 4, 'W': 4, 'X': 4}"
INV-ZZ-0000204,SCH-ZZ-0000008,1008,Boeing 787,08/20/2024,08/20/2024,BLR,MAA,270,303,214,-56,89,27,54,81,108,31,20,11,60,46,14,88,42,46,124,106,18,"{'F': 16, 'P': 11}","{'C': 22, 'J': 16, 'Z': 16}","{'Q': 24, 'R': 16, 'S': 8, 'T': 8, 'H': 16, 'M': 8}","{'Y': 8, 'A': 8, 'B': 4, 'D': 4, 'E': 4, 'G': 8, 'I': 4, 'K': 8, 'L': 4, 'N': 4, 'O': 4, 'U': 8, 'V': 4, 'W': 4, 'X': 4}"
INV-ZZ-0000268,SCH-ZZ-0000072,1008,Boeing 787,08/20/2024,08/20/2024,BLR,MAA,270,286,168,-102,118,27,54,81,108,29,17,12,56,21,35,88,54,34,113,76,37,"{'F': 16, 'P': 11}","{'C': 22, 'J': 16, 'Z': 16}","{'Q': 24, 'R': 16, 'S': 8, 'T': 8, 'H': 16, 'M': 8}","{'Y': 8, 'A': 8, 'B': 4, 'D': 4, 'E': 4, 'G': 8, 'I': 4, 'K': 8, 'L': 4, 'N': 4, 'O': 4, 'U': 8, 'V': 4, 'W': 4, 'X': 4}"
INV-ZZ-0000332,SCH-ZZ-0000136,1008,Boeing 787,08/20/2024,08/20/2024,BLR,MAA,270,287,194,-76,93,27,54,81,108,29,13,16,59,43,16,85,60,25,114,78,36,"{'F': 16, 'P': 11}","{'C': 22, 'J': 16, 'Z': 16}","{'Q': 24, 'R': 16, 'S': 8, 'T': 8, 'H': 16, 'M': 8}","{'Y': 8, 'A': 8, 'B': 4, 'D': 4, 'E': 4, 'G': 8, 'I': 4, 'K': 8, 'L': 4, 'N': 4, 'O': 4, 'U': 8, 'V': 4, 'W': 4, 'X': 4}"
INV-ZZ-0000206,SCH-ZZ-0000010,1010,Boeing 787,08/20/2024,08/20/2024,BLR,BOM,270,284,220,-50,64,27,54,81,108,31,21,10,55,26,29,83,65,18,115,108,7,"{'F': 16, 'P': 11}","{'C': 22, 'J': 16, 'Z': 16}","{'Q': 24, 'R': 16, 'S': 8, 'T': 8, 'H': 16, 'M': 8}","{'Y': 8, 'A': 8, 'B': 4, 'D': 4, 'E': 4, 'G': 8, 'I': 4, 'K': 8, 'L': 4, 'N': 4, 'O': 4, 'U': 8, 'V': 4, 'W': 4, 'X': 4}"
INV-ZZ-0000270,SCH-ZZ-0000074,1010,Boeing 787,08/20/2024,08/20/2024,BLR,BOM,270,291,133,-137,158,27,54,81,108,29,14,15,55,29,26,85,49,36,122,41,81,"{'F': 16, 'P': 11}","{'C': 22, 'J': 16, 'Z': 16}","{'Q': 24, 'R': 16, 'S': 8, 'T': 8, 'H': 16, 'M': 8}","{'Y': 8, 'A': 8, 'B': 4, 'D': 4, 'E': 4, 'G': 8, 'I': 4, 'K': 8, 'L': 4, 'N': 4, 'O': 4, 'U': 8, 'V': 4, 'W': 4, 'X': 4}"
INV-ZZ-0000334,SCH-ZZ-0000138,1010,Boeing 787,08/20/2024,08/20/2024,BLR,BOM,270,283,239,-31,44,27,54,81,108,30,27,3,55,50,5,86,57,29,112,105,7,"{'F': 16, 'P': 11}","{'C': 22, 'J': 16, 'Z': 16}","{'Q': 24, 'R': 16, 'S': 8, 'T': 8, 'H': 16, 'M': 8}","{'Y': 8, 'A': 8, 'B': 4, 'D': 4, 'E': 4, 'G': 8, 'I': 4, 'K': 8, 'L': 4, 'N': 4, 'O': 4, 'U': 8, 'V': 4, 'W': 4, 'X': 4}"
INV-ZZ-0000207,SCH-ZZ-0000011,1011,Boeing 787,08/20/2024,08/20/2024,BLR,DUB,270,285,186,-84,99,27,54,81,108,31,20,11,55,52,3,82,54,28,117,60,57,"{'F': 16, 'P': 11}","{'C': 22, 'J': 16, 'Z': 16}","{'Q': 24, 'R': 16, 'S': 8, 'T': 8, 'H': 16, 'M': 8}","{'Y': 8, 'A': 8, 'B': 4, 'D': 4, 'E': 4, 'G': 8, 'I': 4, 'K': 8, 'L': 4, 'N': 4, 'O': 4, 'U': 8, 'V': 4, 'W': 4, 'X': 4}"
INV-ZZ-0000271,SCH-ZZ-0000075,1011,Boeing 787,08/20/2024,08/20/2024,BLR,DUB,270,298,157,-113,141,27,54,81,108,30,26,4,59,35,24,84,50,34,125,46,79,"{'F': 16, 'P': 11}","{'C': 22, 'J': 16, 'Z': 16}","{'Q': 24, 'R': 16, 'S': 8, 'T': 8, 'H': 16, 'M': 8}","{'Y': 8, 'A': 8, 'B': 4, 'D': 4, 'E': 4, 'G': 8, 'I': 4, 'K': 8, 'L': 4, 'N': 4, 'O': 4, 'U': 8, 'V': 4, 'W': 4, 'X': 4}"
INV-ZZ-0000335,SCH-ZZ-0000139,1011,Boeing 787,08/20/2024,08/20/2024,BLR,DUB,270,279,185,-85,94,27,54,81,108,28,17,11,56,24,32,82,70,12,113,74,39,"{'F': 16, 'P': 11}","{'C': 22, 'J': 16, 'Z': 16}","{'Q': 24, 'R': 16, 'S': 8, 'T': 8, 'H': 16, 'M': 8}","{'Y': 8, 'A': 8, 'B': 4, 'D': 4, 'E': 4, 'G': 8, 'I': 4, 'K': 8, 'L': 4, 'N': 4, 'O': 4, 'U': 8, 'V': 4, 'W': 4, 'X': 4}"
INV-ZZ-0000208,SCH-ZZ-0000012,1012,Boeing 787,08/20/2024,08/20/2024,BLR,VNS,270,287,148,-122,139,27,54,81,108,28,25,3,56,25,31,87,58,29,116,40,76,"{'F': 16, 'P': 11}","{'C': 22, 'J': 16, 'Z': 16}","{'Q': 24, 'R': 16, 'S': 8, 'T': 8, 'H': 16, 'M': 8}","{'Y': 8, 'A': 8, 'B': 4, 'D': 4, 'E': 4, 'G': 8, 'I': 4, 'K': 8, 'L': 4, 'N': 4, 'O': 4, 'U': 8, 'V': 4, 'W': 4, 'X': 4}"
INV-ZZ-0000272,SCH-ZZ-0000076,1012,Boeing 787,08/20/2024,08/20/2024,BLR,VNS,270,300,245,-25,55,27,54,81,108,29,12,17,61,51,10,88,81,7,122,101,21,"{'F': 16, 'P': 11}","{'C': 22, 'J': 16, 'Z': 16}","{'Q': 24, 'R': 16, 'S': 8, 'T': 8, 'H': 16, 'M': 8}","{'Y': 8, 'A': 8, 'B': 4, 'D': 4, 'E': 4, 'G': 8, 'I': 4, 'K': 8, 'L': 4, 'N': 4, 'O': 4, 'U': 8, 'V': 4, 'W': 4, 'X': 4}"
INV-ZZ-0000336,SCH-ZZ-0000140,1012,Boeing 787,08/20/2024,08/20/2024,BLR,VNS,270,282,200,-70,82,27,54,81,108,29,26,3,57,29,28,86,67,19,110,78,32,"{'F': 16, 'P': 11}","{'C': 22, 'J': 16, 'Z': 16}","{'Q': 24, 'R': 16, 'S': 8, 'T': 8, 'H': 16, 'M': 8}","{'Y': 8, 'A': 8, 'B': 4, 'D': 4, 'E': 4, 'G': 8, 'I': 4, 'K': 8, 'L': 4, 'N': 4, 'O': 4, 'U': 8, 'V': 4, 'W': 4, 'X': 4}"
INV-ZZ-0000209,SCH-ZZ-0000013,1013,Boeing 787,08/20/2024,08/20/2024,BLR,JFK,270,292,188,-82,104,27,54,81,108,32,15,17,57,42,15,84,77,7,119,54,65,"{'F': 16, 'P': 11}","{'C': 22, 'J': 16, 'Z': 16}","{'Q': 24, 'R': 16, 'S': 8, 'T': 8, 'H': 16, 'M': 8}","{'Y': 8, 'A': 8, 'B': 4, 'D': 4, 'E': 4, 'G': 8, 'I': 4, 'K': 8, 'L': 4, 'N': 4, 'O': 4, 'U': 8, 'V': 4, 'W': 4, 'X': 4}"
INV-ZZ-0000273,SCH-ZZ-0000077,1013,Boeing 787,08/20/2024,08/20/2024,BLR,JFK,270,285,198,-72,87,27,54,81,108,29,11,18,55,43,12,82,53,29,119,91,28,"{'F': 16, 'P': 11}","{'C': 22, 'J': 16, 'Z': 16}","{'Q': 24, 'R': 16, 'S': 8, 'T': 8, 'H': 16, 'M': 8}","{'Y': 8, 'A': 8, 'B': 4, 'D': 4, 'E': 4, 'G': 8, 'I': 4, 'K': 8, 'L': 4, 'N': 4, 'O': 4, 'U': 8, 'V': 4, 'W': 4, 'X': 4}"
INV-ZZ-0000337,SCH-ZZ-0000141,1013,Boeing 787,08/20/2024,08/20/2024,BLR,JFK,270,299,150,-120,149,27,54,81,108,31,14,17,58,32,26,87,54,33,123,50,73,"{'F': 16, 'P': 11}","{'C': 22, 'J': 16, 'Z': 16}","{'Q': 24, 'R': 16, 'S': 8, 'T': 8, 'H': 16, 'M': 8}","{'Y': 8, 'A': 8, 'B': 4, 'D': 4, 'E': 4, 'G': 8, 'I': 4, 'K': 8, 'L': 4, 'N': 4, 'O': 4, 'U': 8, 'V': 4, 'W': 4, 'X': 4}"
INV-ZZ-0000210,SCH-ZZ-0000014,1014,Boeing 787,08/20/2024,08/20/2024,BLR,DEL,270,305,203,-67,102,27,54,81,108,32,17,15,59,43,16,91,39,52,123,104,19,"{'F': 16, 'P': 11}","{'C': 22, 'J': 16, 'Z': 16}","{'Q': 24, 'R': 16, 'S': 8, 'T': 8, 'H': 16, 'M': 8}","{'Y': 8, 'A': 8, 'B': 4, 'D': 4, 'E': 4, 'G': 8, 'I': 4, 'K': 8, 'L': 4, 'N': 4, 'O': 4, 'U': 8, 'V': 4, 'W': 4, 'X': 4}"
INV-ZZ-0000274,SCH-ZZ-0000078,1014,Boeing 787,08/20/2024,08/20/2024,BLR,DEL,270,287,227,-43,60,27,54,81,108,28,14,14,57,43,14,88,79,9,114,91,23,"{'F': 16, 'P': 11}","{'C': 22, 'J': 16, 'Z': 16}","{'Q': 24, 'R': 16, 'S': 8, 'T': 8, 'H': 16, 'M': 8}","{'Y': 8, 'A': 8, 'B': 4, 'D': 4, 'E': 4, 'G': 8, 'I': 4, 'K': 8, 'L': 4, 'N': 4, 'O': 4, 'U': 8, 'V': 4, 'W': 4, 'X': 4}"
INV-ZZ-0000338,SCH-ZZ-0000142,1014,Boeing 787,08/20/2024,08/20/2024,BLR,DEL,270,292,167,-103,125,27,54,81,108,31,14,17,58,25,33,83,58,25,120,70,50,"{'F': 16, 'P': 11}","{'C': 22, 'J': 16, 'Z': 16}","{'Q': 24, 'R': 16, 'S': 8, 'T': 8, 'H': 16, 'M': 8}","{'Y': 8, 'A': 8, 'B': 4, 'D': 4, 'E': 4, 'G': 8, 'I': 4, 'K': 8, 'L': 4, 'N': 4, 'O': 4, 'U': 8, 'V': 4, 'W': 4, 'X': 4}"
INV-ZZ-0000211,SCH-ZZ-0000015,1015,Boeing 787,08/20/2024,08/20/2024,BLR,LAX,270,295,171,-99,124,27,54,81,108,29,24,5,55,38,17,85,54,31,126,55,71,"{'F': 16, 'P': 11}","{'C': 22, 'J': 16, 'Z': 16}","{'Q': 24, 'R': 16, 'S': 8, 'T': 8, 'H': 16, 'M': 8}","{'Y': 8, 'A': 8, 'B': 4, 'D': 4, 'E': 4, 'G': 8, 'I': 4, 'K': 8, 'L': 4, 'N': 4, 'O': 4, 'U': 8, 'V': 4, 'W': 4, 'X': 4}"
INV-ZZ-0000275,SCH-ZZ-0000079,1015,Boeing 787,08/20/2024,08/20/2024,BLR,LAX,270,298,189,-81,109,27,54,81,108,29,11,18,56,51,5,85,60,25,128,67,61,"{'F': 16, 'P': 11}","{'C': 22, 'J': 16, 'Z': 16}","{'Q': 24, 'R': 16, 'S': 8, 'T': 8, 'H': 16, 'M': 8}","{'Y': 8, 'A': 8, 'B': 4, 'D': 4, 'E': 4, 'G': 8, 'I': 4, 'K': 8, 'L': 4, 'N': 4, 'O': 4, 'U': 8, 'V': 4, 'W': 4, 'X': 4}"
INV-ZZ-0000339,SCH-ZZ-0000143,1015,Boeing 787,08/20/2024,08/20/2024,BLR,LAX,270,291,218,-52,73,27,54,81,108,30,25,5,61,43,18,87,79,8,113,71,42,"{'F': 16, 'P': 11}","{'C': 22, 'J': 16, 'Z': 16}","{'Q': 24, 'R': 16, 'S': 8, 'T': 8, 'H': 16, 'M': 8}","{'Y': 8, 'A': 8, 'B': 4, 'D': 4, 'E': 4, 'G': 8, 'I': 4, 'K': 8, 'L': 4, 'N': 4, 'O': 4, 'U': 8, 'V': 4, 'W': 4, 'X': 4}"
INV-ZZ-0000212,SCH-ZZ-0000016,1016,Boeing 787,08/20/2024,08/20/2024,BOM,MAA,270,305,239,-31,66,27,54,81,108,31,15,16,61,40,21,90,77,13,123,107,16,"{'F': 16, 'P': 11}","{'C': 22, 'J': 16, 'Z': 16}","{'Q': 24, 'R': 16, 'S': 8, 'T': 8, 'H': 16, 'M': 8}","{'Y': 8, 'A': 8, 'B': 4, 'D': 4, 'E': 4, 'G': 8, 'I': 4, 'K': 8, 'L': 4, 'N': 4, 'O': 4, 'U': 8, 'V': 4, 'W': 4, 'X': 4}"
INV-ZZ-0000276,SCH-ZZ-0000080,1016,Boeing 787,08/20/2024,08/20/2024,BOM,MAA,270,293,121,-149,172,27,54,81,108,29,12,17,55,33,22,87,35,52,122,41,81,"{'F': 16, 'P': 11}","{'C': 22, 'J': 16, 'Z': 16}","{'Q': 24, 'R': 16, 'S': 8, 'T': 8, 'H': 16, 'M': 8}","{'Y': 8, 'A': 8, 'B': 4, 'D': 4, 'E': 4, 'G': 8, 'I': 4, 'K': 8, 'L': 4, 'N': 4, 'O': 4, 'U': 8, 'V': 4, 'W': 4, 'X': 4}"
INV-ZZ-0000340,SCH-ZZ-0000144,1016,Boeing 787,08/20/2024,08/20/2024,BOM,MAA,270,287,202,-68,85,27,54,81,108,30,10,20,55,33,22,91,77,14,111,82,29,"{'F': 16, 'P': 11}","{'C': 22, 'J': 16, 'Z': 16}","{'Q': 24, 'R': 16, 'S': 8, 'T': 8, 'H': 16, 'M': 8}","{'Y': 8, 'A': 8, 'B': 4, 'D': 4, 'E': 4, 'G': 8, 'I': 4, 'K': 8, 'L': 4, 'N': 4, 'O': 4, 'U': 8, 'V': 4, 'W': 4, 'X': 4}"
INV-ZZ-0000213,SCH-ZZ-0000017,1017,Boeing 787,08/20/2024,08/20/2024,BOM,BLR,270,284,209,-61,75,27,54,81,108,29,16,13,55,36,19,87,64,23,113,93,20,"{'F': 16, 'P': 11}","{'C': 22, 'J': 16, 'Z': 16}","{'Q': 24, 'R': 16, 'S': 8, 'T': 8, 'H': 16, 'M': 8}","{'Y': 8, 'A': 8, 'B': 4, 'D': 4, 'E': 4, 'G': 8, 'I': 4, 'K': 8, 'L': 4, 'N': 4, 'O': 4, 'U': 8, 'V': 4, 'W': 4, 'X': 4}"
INV-ZZ-0000277,SCH-ZZ-0000081,1017,Boeing 787,08/20/2024,08/20/2024,BOM,BLR,270,282,145,-125,137,27,54,81,108,29,10,19,59,51,8,82,37,45,112,47,65,"{'F': 16, 'P': 11}","{'C': 22, 'J': 16, 'Z': 16}","{'Q': 24, 'R': 16, 'S': 8, 'T': 8, 'H': 16, 'M': 8}","{'Y': 8, 'A': 8, 'B': 4, 'D': 4, 'E': 4, 'G': 8, 'I': 4, 'K': 8, 'L': 4, 'N': 4, 'O': 4, 'U': 8, 'V': 4, 'W': 4, 'X': 4}"
INV-ZZ-0000341,SCH-ZZ-0000145,1017,Boeing 787,08/20/2024,08/20/2024,BOM,BLR,270,296,181,-89,115,27,54,81,108,30,12,18,58,40,18,83,43,40,125,86,39,"{'F': 16, 'P': 11}","{'C': 22, 'J': 16, 'Z': 16}","{'Q': 24, 'R': 16, 'S': 8, 'T': 8, 'H': 16, 'M': 8}","{'Y': 8, 'A': 8, 'B': 4, 'D': 4, 'E': 4, 'G': 8, 'I': 4, 'K': 8, 'L': 4, 'N': 4, 'O': 4, 'U': 8, 'V': 4, 'W': 4, 'X': 4}"
INV-ZZ-0000215,SCH-ZZ-0000019,1019,Boeing 787,08/20/2024,08/20/2024,BOM,DUB,270,285,200,-70,85,27,54,81,108,28,23,5,59,31,28,87,62,25,111,84,27,"{'F': 16, 'P': 11}","{'C': 22, 'J': 16, 'Z': 16}","{'Q': 24, 'R': 16, 'S': 8, 'T': 8, 'H': 16, 'M': 8}","{'Y': 8, 'A': 8, 'B': 4, 'D': 4, 'E': 4, 'G': 8, 'I': 4, 'K': 8, 'L': 4, 'N': 4, 'O': 4, 'U': 8, 'V': 4, 'W': 4, 'X': 4}"
INV-ZZ-0000279,SCH-ZZ-0000083,1019,Boeing 787,08/20/2024,08/20/2024,BOM,DUB,270,293,144,-126,149,27,54,81,108,31,15,16,61,20,41,82,45,37,119,64,55,"{'F': 16, 'P': 11}","{'C': 22, 'J': 16, 'Z': 16}","{'Q': 24, 'R': 16, 'S': 8, 'T': 8, 'H': 16, 'M': 8}","{'Y': 8, 'A': 8, 'B': 4, 'D': 4, 'E': 4, 'G': 8, 'I': 4, 'K': 8, 'L': 4, 'N': 4, 'O': 4, 'U': 8, 'V': 4, 'W': 4, 'X': 4}"
INV-ZZ-0000343,SCH-ZZ-0000147,1019,Boeing 787,08/20/2024,08/20/2024,BOM,DUB,270,299,162,-108,137,27,54,81,108,31,21,10,61,49,12,83,50,33,124,42,82,"{'F': 16, 'P': 11}","{'C': 22, 'J': 16, 'Z': 16}","{'Q': 24, 'R': 16, 'S': 8, 'T': 8, 'H': 16, 'M': 8}","{'Y': 8, 'A': 8, 'B': 4, 'D': 4, 'E': 4, 'G': 8, 'I': 4, 'K': 8, 'L': 4, 'N': 4, 'O': 4, 'U': 8, 'V': 4, 'W': 4, 'X': 4}"
INV-ZZ-0000216,SCH-ZZ-0000020,1020,Boeing 787,08/20/2024,08/20/2024,BOM,VNS,270,294,149,-121,145,27,54,81,108,31,10,21,61,34,27,85,37,48,117,68,49,"{'F': 16, 'P': 11}","{'C': 22, 'J': 16, 'Z': 16}","{'Q': 24, 'R': 16, 'S': 8, 'T': 8, 'H': 16, 'M': 8}","{'Y': 8, 'A': 8, 'B': 4, 'D': 4, 'E': 4, 'G': 8, 'I': 4, 'K': 8, 'L': 4, 'N': 4, 'O': 4, 'U': 8, 'V': 4, 'W': 4, 'X': 4}"
INV-ZZ-0000280,SCH-ZZ-0000084,1020,Boeing 787,08/20/2024,08/20/2024,BOM,VNS,270,303,204,-66,99,27,54,81,108,31,15,16,55,38,17,91,52,39,126,99,27,"{'F': 16, 'P': 11}","{'C': 22, 'J': 16, 'Z': 16}","{'Q': 24, 'R': 16, 'S': 8, 'T': 8, 'H': 16, 'M': 8}","{'Y': 8, 'A': 8, 'B': 4, 'D': 4, 'E': 4, 'G': 8, 'I': 4, 'K': 8, 'L': 4, 'N': 4, 'O': 4, 'U': 8, 'V': 4, 'W': 4, 'X': 4}"
INV-ZZ-0000344,SCH-ZZ-0000148,1020,Boeing 787,08/20/2024,08/20/2024,BOM,VNS,270,292,209,-61,83,27,54,81,108,29,24,5,59,43,16,83,45,38,121,97,24,"{'F': 16, 'P': 11}","{'C': 22, 'J': 16, 'Z': 16}","{'Q': 24, 'R': 16, 'S': 8, 'T': 8, 'H': 16, 'M': 8}","{'Y': 8, 'A': 8, 'B': 4, 'D': 4, 'E': 4, 'G': 8, 'I': 4, 'K': 8, 'L': 4, 'N': 4, 'O': 4, 'U': 8, 'V': 4, 'W': 4, 'X': 4}"
INV-ZZ-0000217,SCH-ZZ-0000021,1021,Boeing 787,08/20/2024,08/20/2024,BOM,JFK,270,296,203,-67,93,27,54,81,108,28,14,14,55,50,5,86,41,45,127,98,29,"{'F': 16, 'P': 11}","{'C': 22, 'J': 16, 'Z': 16}","{'Q': 24, 'R': 16, 'S': 8, 'T': 8, 'H': 16, 'M': 8}","{'Y': 8, 'A': 8, 'B': 4, 'D': 4, 'E': 4, 'G': 8, 'I': 4, 'K': 8, 'L': 4, 'N': 4, 'O': 4, 'U': 8, 'V': 4, 'W': 4, 'X': 4}"
INV-ZZ-0000281,SCH-ZZ-0000085,1021,Boeing 787,08/20/2024,08/20/2024,BOM,JFK,270,285,175,-95,110,27,54,81,108,32,21,11,56,52,4,88,41,47,109,61,48,"{'F': 16, 'P': 11}","{'C': 22, 'J': 16, 'Z': 16}","{'Q': 24, 'R': 16, 'S': 8, 'T': 8, 'H': 16, 'M': 8}","{'Y': 8, 'A': 8, 'B': 4, 'D': 4, 'E': 4, 'G': 8, 'I': 4, 'K': 8, 'L': 4, 'N': 4, 'O': 4, 'U': 8, 'V': 4, 'W': 4, 'X': 4}"
INV-ZZ-0000345,SCH-ZZ-0000149,1021,Boeing 787,08/20/2024,08/20/2024,BOM,JFK,270,288,194,-76,94,27,54,81,108,32,25,7,55,27,28,84,54,30,117,88,29,"{'F': 16, 'P': 11}","{'C': 22, 'J': 16, 'Z': 16}","{'Q': 24, 'R': 16, 'S': 8, 'T': 8, 'H': 16, 'M': 8}","{'Y': 8, 'A': 8, 'B': 4, 'D': 4, 'E': 4, 'G': 8, 'I': 4, 'K': 8, 'L': 4, 'N': 4, 'O': 4, 'U': 8, 'V': 4, 'W': 4, 'X': 4}"
INV-ZZ-0000218,SCH-ZZ-0000022,1022,Boeing 787,08/20/2024,08/20/2024,BOM,DEL,270,303,197,-73,106,27,54,81,108,31,16,15,59,38,21,86,43,43,127,100,27,"{'F': 16, 'P': 11}","{'C': 22, 'J': 16, 'Z': 16}","{'Q': 24, 'R': 16, 'S': 8, 'T': 8, 'H': 16, 'M': 8}","{'Y': 8, 'A': 8, 'B': 4, 'D': 4, 'E': 4, 'G': 8, 'I': 4, 'K': 8, 'L': 4, 'N': 4, 'O': 4, 'U': 8, 'V': 4, 'W': 4, 'X': 4}"
INV-ZZ-0000282,SCH-ZZ-0000086,1022,Boeing 787,08/20/2024,08/20/2024,BOM,DEL,270,302,159,-111,143,27,54,81,108,30,20,10,59,34,25,91,56,35,122,49,73,"{'F': 16, 'P': 11}","{'C': 22, 'J': 16, 'Z': 16}","{'Q': 24, 'R': 16, 'S': 8, 'T': 8, 'H': 16, 'M': 8}","{'Y': 8, 'A': 8, 'B': 4, 'D': 4, 'E': 4, 'G': 8, 'I': 4, 'K': 8, 'L': 4, 'N': 4, 'O': 4, 'U': 8, 'V': 4, 'W': 4, 'X': 4}"
INV-ZZ-0000346,SCH-ZZ-0000150,1022,Boeing 787,08/20/2024,08/20/2024,BOM,DEL,270,293,184,-86,109,27,54,81,108,29,10,19,61,36,25,90,81,9,113,57,56,"{'F': 16, 'P': 11}","{'C': 22, 'J': 16, 'Z': 16}","{'Q': 24, 'R': 16, 'S': 8, 'T': 8, 'H': 16, 'M': 8}","{'Y': 8, 'A': 8, 'B': 4, 'D': 4, 'E': 4, 'G': 8, 'I': 4, 'K': 8, 'L': 4, 'N': 4, 'O': 4, 'U': 8, 'V': 4, 'W': 4, 'X': 4}"
INV-ZZ-0000219,SCH-ZZ-0000023,1023,Boeing 787,08/20/2024,08/20/2024,BOM,LAX,270,289,208,-62,81,27,54,81,108,31,25,6,57,48,9,87,64,23,114,71,43,"{'F': 16, 'P': 11}","{'C': 22, 'J': 16, 'Z': 16}","{'Q': 24, 'R': 16, 'S': 8, 'T': 8, 'H': 16, 'M': 8}","{'Y': 8, 'A': 8, 'B': 4, 'D': 4, 'E': 4, 'G': 8, 'I': 4, 'K': 8, 'L': 4, 'N': 4, 'O': 4, 'U': 8, 'V': 4, 'W': 4, 'X': 4}"
INV-ZZ-0000283,SCH-ZZ-0000087,1023,Boeing 787,08/20/2024,08/20/2024,BOM,LAX,270,289,165,-105,124,27,54,81,108,31,11,20,57,29,28,90,71,19,111,54,57,"{'F': 16, 'P': 11}","{'C': 22, 'J': 16, 'Z': 16}","{'Q': 24, 'R': 16, 'S': 8, 'T': 8, 'H': 16, 'M': 8}","{'Y': 8, 'A': 8, 'B': 4, 'D': 4, 'E': 4, 'G': 8, 'I': 4, 'K': 8, 'L': 4, 'N': 4, 'O': 4, 'U': 8, 'V': 4, 'W': 4, 'X': 4}"
INV-ZZ-0000347,SCH-ZZ-0000151,1023,Boeing 787,08/20/2024,08/20/2024,BOM,LAX,270,283,193,-77,90,27,54,81,108,31,17,14,57,42,15,82,44,38,113,90,23,"{'F': 16, 'P': 11}","{'C': 22, 'J': 16, 'Z': 16}","{'Q': 24, 'R': 16, 'S': 8, 'T': 8, 'H': 16, 'M': 8}","{'Y': 8, 'A': 8, 'B': 4, 'D': 4, 'E': 4, 'G': 8, 'I': 4, 'K': 8, 'L': 4, 'N': 4, 'O': 4, 'U': 8, 'V': 4, 'W': 4, 'X': 4}"
INV-ZZ-0000220,SCH-ZZ-0000024,1024,Boeing 787,08/20/2024,08/20/2024,DUB,MAA,270,291,186,-84,105,27,54,81,108,30,21,9,56,37,19,90,78,12,115,50,65,"{'F': 16, 'P': 11}","{'C': 22, 'J': 16, 'Z': 16}","{'Q': 24, 'R': 16, 'S': 8, 'T': 8, 'H': 16, 'M': 8}","{'Y': 8, 'A': 8, 'B': 4, 'D': 4, 'E': 4, 'G': 8, 'I': 4, 'K': 8, 'L': 4, 'N': 4, 'O': 4, 'U': 8, 'V': 4, 'W': 4, 'X': 4}"
INV-ZZ-0000284,SCH-ZZ-0000088,1024,Boeing 787,08/20/2024,08/20/2024,DUB,MAA,270,289,202,-68,87,27,54,81,108,30,24,6,59,26,33,84,61,23,116,91,25,"{'F': 16, 'P': 11}","{'C': 22, 'J': 16, 'Z': 16}","{'Q': 24, 'R': 16, 'S': 8, 'T': 8, 'H': 16, 'M': 8}","{'Y': 8, 'A': 8, 'B': 4, 'D': 4, 'E': 4, 'G': 8, 'I': 4, 'K': 8, 'L': 4, 'N': 4, 'O': 4, 'U': 8, 'V': 4, 'W': 4, 'X': 4}"
INV-ZZ-0000348,SCH-ZZ-0000152,1024,Boeing 787,08/20/2024,08/20/2024,DUB,MAA,270,293,124,-146,169,27,54,81,108,29,13,16,59,21,38,84,49,35,121,41,80,"{'F': 16, 'P': 11}","{'C': 22, 'J': 16, 'Z': 16}","{'Q': 24, 'R': 16, 'S': 8, 'T': 8, 'H': 16, 'M': 8}","{'Y': 8, 'A': 8, 'B': 4, 'D': 4, 'E': 4, 'G': 8, 'I': 4, 'K': 8, 'L': 4, 'N': 4, 'O': 4, 'U': 8, 'V': 4, 'W': 4, 'X': 4}"
INV-ZZ-0000221,SCH-ZZ-0000025,1025,Boeing 787,08/20/2024,08/20/2024,DUB,BLR,270,293,223,-47,70,27,54,81,108,30,22,8,57,34,23,86,66,20,120,101,19,"{'F': 16, 'P': 11}","{'C': 22, 'J': 16, 'Z': 16}","{'Q': 24, 'R': 16, 'S': 8, 'T': 8, 'H': 16, 'M': 8}","{'Y': 8, 'A': 8, 'B': 4, 'D': 4, 'E': 4, 'G': 8, 'I': 4, 'K': 8, 'L': 4, 'N': 4, 'O': 4, 'U': 8, 'V': 4, 'W': 4, 'X': 4}"
INV-ZZ-0000285,SCH-ZZ-0000089,1025,Boeing 787,08/20/2024,08/20/2024,DUB,BLR,270,306,190,-80,116,27,54,81,108,29,11,18,59,46,13,91,38,53,127,95,32,"{'F': 16, 'P': 11}","{'C': 22, 'J': 16, 'Z': 16}","{'Q': 24, 'R': 16, 'S': 8, 'T': 8, 'H': 16, 'M': 8}","{'Y': 8, 'A': 8, 'B': 4, 'D': 4, 'E': 4, 'G': 8, 'I': 4, 'K': 8, 'L': 4, 'N': 4, 'O': 4, 'U': 8, 'V': 4, 'W': 4, 'X': 4}"
INV-ZZ-0000349,SCH-ZZ-0000153,1025,Boeing 787,08/20/2024,08/20/2024,DUB,BLR,270,296,182,-88,114,27,54,81,108,30,11,19,56,23,33,86,81,5,124,67,57,"{'F': 16, 'P': 11}","{'C': 22, 'J': 16, 'Z': 16}","{'Q': 24, 'R': 16, 'S': 8, 'T': 8, 'H': 16, 'M': 8}","{'Y': 8, 'A': 8, 'B': 4, 'D': 4, 'E': 4, 'G': 8, 'I': 4, 'K': 8, 'L': 4, 'N': 4, 'O': 4, 'U': 8, 'V': 4, 'W': 4, 'X': 4}"
INV-ZZ-0000222,SCH-ZZ-0000026,1026,Boeing 787,08/20/2024,08/20/2024,DUB,BOM,270,298,197,-73,101,27,54,81,108,28,13,15,61,20,41,90,78,12,119,86,33,"{'F': 16, 'P': 11}","{'C': 22, 'J': 16, 'Z': 16}","{'Q': 24, 'R': 16, 'S': 8, 'T': 8, 'H': 16, 'M': 8}","{'Y': 8, 'A': 8, 'B': 4, 'D': 4, 'E': 4, 'G': 8, 'I': 4, 'K': 8, 'L': 4, 'N': 4, 'O': 4, 'U': 8, 'V': 4, 'W': 4, 'X': 4}"
INV-ZZ-0000286,SCH-ZZ-0000090,1026,Boeing 787,08/20/2024,08/20/2024,DUB,BOM,270,305,181,-89,124,27,54,81,108,29,24,5,60,33,27,89,39,50,127,85,42,"{'F': 16, 'P': 11}","{'C': 22, 'J': 16, 'Z': 16}","{'Q': 24, 'R': 16, 'S': 8, 'T': 8, 'H': 16, 'M': 8}","{'Y': 8, 'A': 8, 'B': 4, 'D': 4, 'E': 4, 'G': 8, 'I': 4, 'K': 8, 'L': 4, 'N': 4, 'O': 4, 'U': 8, 'V': 4, 'W': 4, 'X': 4}"
INV-ZZ-0000350,SCH-ZZ-0000154,1026,Boeing 787,08/20/2024,08/20/2024,DUB,BOM,270,289,236,-34,53,27,54,81,108,29,11,18,56,37,19,89,80,9,115,108,7,"{'F': 16, 'P': 11}","{'C': 22, 'J': 16, 'Z': 16}","{'Q': 24, 'R': 16, 'S': 8, 'T': 8, 'H': 16, 'M': 8}","{'Y': 8, 'A': 8, 'B': 4, 'D': 4, 'E': 4, 'G': 8, 'I': 4, 'K': 8, 'L': 4, 'N': 4, 'O': 4, 'U': 8, 'V': 4, 'W': 4, 'X': 4}"
INV-ZZ-0000224,SCH-ZZ-0000028,1028,Boeing 787,08/20/2024,08/20/2024,DUB,VNS,270,286,177,-93,109,27,54,81,108,29,17,12,60,28,32,88,66,22,109,66,43,"{'F': 16, 'P': 11}","{'C': 22, 'J': 16, 'Z': 16}","{'Q': 24, 'R': 16, 'S': 8, 'T': 8, 'H': 16, 'M': 8}","{'Y': 8, 'A': 8, 'B': 4, 'D': 4, 'E': 4, 'G': 8, 'I': 4, 'K': 8, 'L': 4, 'N': 4, 'O': 4, 'U': 8, 'V': 4, 'W': 4, 'X': 4}"
INV-ZZ-0000288,SCH-ZZ-0000092,1028,Boeing 787,08/20/2024,08/20/2024,DUB,VNS,270,287,185,-85,102,27,54,81,108,29,16,13,57,26,31,89,62,27,112,81,31,"{'F': 16, 'P': 11}","{'C': 22, 'J': 16, 'Z': 16}","{'Q': 24, 'R': 16, 'S': 8, 'T': 8, 'H': 16, 'M': 8}","{'Y': 8, 'A': 8, 'B': 4, 'D': 4, 'E': 4, 'G': 8, 'I': 4, 'K': 8, 'L': 4, 'N': 4, 'O': 4, 'U': 8, 'V': 4, 'W': 4, 'X': 4}"
INV-ZZ-0000352,SCH-ZZ-0000156,1028,Boeing 787,08/20/2024,08/20/2024,DUB,VNS,270,296,165,-105,131,27,54,81,108,31,23,8,60,43,17,83,37,46,122,62,60,"{'F': 16, 'P': 11}","{'C': 22, 'J': 16, 'Z': 16}","{'Q': 24, 'R': 16, 'S': 8, 'T': 8, 'H': 16, 'M': 8}","{'Y': 8, 'A': 8, 'B': 4, 'D': 4, 'E': 4, 'G': 8, 'I': 4, 'K': 8, 'L': 4, 'N': 4, 'O': 4, 'U': 8, 'V': 4, 'W': 4, 'X': 4}"
INV-ZZ-0000225,SCH-ZZ-0000029,1029,Boeing 787,08/20/2024,08/20/2024,DUB,JFK,270,306,184,-86,122,27,54,81,108,31,12,19,60,21,39,88,79,9,127,72,55,"{'F': 16, 'P': 11}","{'C': 22, 'J': 16, 'Z': 16}","{'Q': 24, 'R': 16, 'S': 8, 'T': 8, 'H': 16, 'M': 8}","{'Y': 8, 'A': 8, 'B': 4, 'D': 4, 'E': 4, 'G': 8, 'I': 4, 'K': 8, 'L': 4, 'N': 4, 'O': 4, 'U': 8, 'V': 4, 'W': 4, 'X': 4}"
INV-ZZ-0000289,SCH-ZZ-0000093,1029,Boeing 787,08/20/2024,08/20/2024,DUB,JFK,270,308,215,-55,93,27,54,81,108,32,27,5,61,44,17,91,61,30,124,83,41,"{'F': 16, 'P': 11}","{'C': 22, 'J': 16, 'Z': 16}","{'Q': 24, 'R': 16, 'S': 8, 'T': 8, 'H': 16, 'M': 8}","{'Y': 8, 'A': 8, 'B': 4, 'D': 4, 'E': 4, 'G': 8, 'I': 4, 'K': 8, 'L': 4, 'N': 4, 'O': 4, 'U': 8, 'V': 4, 'W': 4, 'X': 4}"
INV-ZZ-0000353,SCH-ZZ-0000157,1029,Boeing 787,08/20/2024,08/20/2024,DUB,JFK,270,294,140,-130,154,27,54,81,108,32,11,21,57,20,37,91,62,29,114,47,67,"{'F': 16, 'P': 11}","{'C': 22, 'J': 16, 'Z': 16}","{'Q': 24, 'R': 16, 'S': 8, 'T': 8, 'H': 16, 'M': 8}","{'Y': 8, 'A': 8, 'B': 4, 'D': 4, 'E': 4, 'G': 8, 'I': 4, 'K': 8, 'L': 4, 'N': 4, 'O': 4, 'U': 8, 'V': 4, 'W': 4, 'X': 4}"
INV-ZZ-0000226,SCH-ZZ-0000030,1030,Boeing 787,08/20/2024,08/20/2024,DUB,DEL,270,288,195,-75,93,27,54,81,108,31,18,13,61,40,21,82,78,4,114,59,55,"{'F': 16, 'P': 11}","{'C': 22, 'J': 16, 'Z': 16}","{'Q': 24, 'R': 16, 'S': 8, 'T': 8, 'H': 16, 'M': 8}","{'Y': 8, 'A': 8, 'B': 4, 'D': 4, 'E': 4, 'G': 8, 'I': 4, 'K': 8, 'L': 4, 'N': 4, 'O': 4, 'U': 8, 'V': 4, 'W': 4, 'X': 4}"
INV-ZZ-0000290,SCH-ZZ-0000094,1030,Boeing 787,08/20/2024,08/20/2024,DUB,DEL,270,290,187,-83,103,27,54,81,108,28,20,8,55,48,7,89,44,45,118,75,43,"{'F': 16, 'P': 11}","{'C': 22, 'J': 16, 'Z': 16}","{'Q': 24, 'R': 16, 'S': 8, 'T': 8, 'H': 16, 'M': 8}","{'Y': 8, 'A': 8, 'B': 4, 'D': 4, 'E': 4, 'G': 8, 'I': 4, 'K': 8, 'L': 4, 'N': 4, 'O': 4, 'U': 8, 'V': 4, 'W': 4, 'X': 4}"
INV-ZZ-0000354,SCH-ZZ-0000158,1030,Boeing 787,08/20/2024,08/20/2024,DUB,DEL,270,301,154,-116,147,27,54,81,108,29,22,7,59,46,13,85,40,45,128,46,82,"{'F': 16, 'P': 11}","{'C': 22, 'J': 16, 'Z': 16}","{'Q': 24, 'R': 16, 'S': 8, 'T': 8, 'H': 16, 'M': 8}","{'Y': 8, 'A': 8, 'B': 4, 'D': 4, 'E': 4, 'G': 8, 'I': 4, 'K': 8, 'L': 4, 'N': 4, 'O': 4, 'U': 8, 'V': 4, 'W': 4, 'X': 4}"
INV-ZZ-0000227,SCH-ZZ-0000031,1031,Boeing 787,08/20/2024,08/20/2024,DUB,LAX,270,302,228,-42,74,27,54,81,108,31,23,8,59,47,12,88,71,17,124,87,37,"{'F': 16, 'P': 11}","{'C': 22, 'J': 16, 'Z': 16}","{'Q': 24, 'R': 16, 'S': 8, 'T': 8, 'H': 16, 'M': 8}","{'Y': 8, 'A': 8, 'B': 4, 'D': 4, 'E': 4, 'G': 8, 'I': 4, 'K': 8, 'L': 4, 'N': 4, 'O': 4, 'U': 8, 'V': 4, 'W': 4, 'X': 4}"
INV-ZZ-0000291,SCH-ZZ-0000095,1031,Boeing 787,08/20/2024,08/20/2024,DUB,LAX,270,288,167,-103,121,27,54,81,108,29,26,3,56,24,32,90,47,43,113,70,43,"{'F': 16, 'P': 11}","{'C': 22, 'J': 16, 'Z': 16}","{'Q': 24, 'R': 16, 'S': 8, 'T': 8, 'H': 16, 'M': 8}","{'Y': 8, 'A': 8, 'B': 4, 'D': 4, 'E': 4, 'G': 8, 'I': 4, 'K': 8, 'L': 4, 'N': 4, 'O': 4, 'U': 8, 'V': 4, 'W': 4, 'X': 4}"
INV-ZZ-0000355,SCH-ZZ-0000159,1031,Boeing 787,08/20/2024,08/20/2024,DUB,LAX,270,302,209,-61,93,27,54,81,108,30,22,8,59,50,9,90,80,10,123,57,66,"{'F': 16, 'P': 11}","{'C': 22, 'J': 16, 'Z': 16}","{'Q': 24, 'R': 16, 'S': 8, 'T': 8, 'H': 16, 'M': 8}","{'Y': 8, 'A': 8, 'B': 4, 'D': 4, 'E': 4, 'G': 8, 'I': 4, 'K': 8, 'L': 4, 'N': 4, 'O': 4, 'U': 8, 'V': 4, 'W': 4, 'X': 4}"
INV-ZZ-0000228,SCH-ZZ-0000032,1032,Boeing 787,08/20/2024,08/20/2024,VNS,MAA,270,293,192,-78,101,27,54,81,108,32,16,16,57,49,8,87,65,22,117,62,55,"{'F': 16, 'P': 11}","{'C': 22, 'J': 16, 'Z': 16}","{'Q': 24, 'R': 16, 'S': 8, 'T': 8, 'H': 16, 'M': 8}","{'Y': 8, 'A': 8, 'B': 4, 'D': 4, 'E': 4, 'G': 8, 'I': 4, 'K': 8, 'L': 4, 'N': 4, 'O': 4, 'U': 8, 'V': 4, 'W': 4, 'X': 4}"
INV-ZZ-0000292,SCH-ZZ-0000096,1032,Boeing 787,08/20/2024,08/20/2024,VNS,MAA,270,293,199,-71,94,27,54,81,108,28,15,13,58,46,12,89,77,12,118,61,57,"{'F': 16, 'P': 11}","{'C': 22, 'J': 16, 'Z': 16}","{'Q': 24, 'R': 16, 'S': 8, 'T': 8, 'H': 16, 'M': 8}","{'Y': 8, 'A': 8, 'B': 4, 'D': 4, 'E': 4, 'G': 8, 'I': 4, 'K': 8, 'L': 4, 'N': 4, 'O': 4, 'U': 8, 'V': 4, 'W': 4, 'X': 4}"
INV-ZZ-0000356,SCH-ZZ-0000160,1032,Boeing 787,08/20/2024,08/20/2024,VNS,MAA,270,290,150,-120,140,27,54,81,108,31,11,20,61,23,38,82,59,23,116,57,59,"{'F': 16, 'P': 11}","{'C': 22, 'J': 16, 'Z': 16}","{'Q': 24, 'R': 16, 'S': 8, 'T': 8, 'H': 16, 'M': 8}","{'Y': 8, 'A': 8, 'B': 4, 'D': 4, 'E': 4, 'G': 8, 'I': 4, 'K': 8, 'L': 4, 'N': 4, 'O': 4, 'U': 8, 'V': 4, 'W': 4, 'X': 4}"
INV-ZZ-0000229,SCH-ZZ-0000033,1033,Boeing 787,08/20/2024,08/20/2024,VNS,BLR,270,297,141,-129,156,27,54,81,108,31,21,10,58,34,24,89,46,43,119,40,79,"{'F': 16, 'P': 11}","{'C': 22, 'J': 16, 'Z': 16}","{'Q': 24, 'R': 16, 'S': 8, 'T': 8, 'H': 16, 'M': 8}","{'Y': 8, 'A': 8, 'B': 4, 'D': 4, 'E': 4, 'G': 8, 'I': 4, 'K': 8, 'L': 4, 'N': 4, 'O': 4, 'U': 8, 'V': 4, 'W': 4, 'X': 4}"
INV-ZZ-0000293,SCH-ZZ-0000097,1033,Boeing 787,08/20/2024,08/20/2024,VNS,BLR,270,296,173,-97,123,27,54,81,108,30,24,6,58,36,22,85,73,12,123,40,83,"{'F': 16, 'P': 11}","{'C': 22, 'J': 16, 'Z': 16}","{'Q': 24, 'R': 16, 'S': 8, 'T': 8, 'H': 16, 'M': 8}","{'Y': 8, 'A': 8, 'B': 4, 'D': 4, 'E': 4, 'G': 8, 'I': 4, 'K': 8, 'L': 4, 'N': 4, 'O': 4, 'U': 8, 'V': 4, 'W': 4, 'X': 4}"
INV-ZZ-0000357,SCH-ZZ-0000161,1033,Boeing 787,08/20/2024,08/20/2024,VNS,BLR,270,287,186,-84,101,27,54,81,108,32,16,16,59,50,9,83,49,34,113,71,42,"{'F': 16, 'P': 11}","{'C': 22, 'J': 16, 'Z': 16}","{'Q': 24, 'R': 16, 'S': 8, 'T': 8, 'H': 16, 'M': 8}","{'Y': 8, 'A': 8, 'B': 4, 'D': 4, 'E': 4, 'G': 8, 'I': 4, 'K': 8, 'L': 4, 'N': 4, 'O': 4, 'U': 8, 'V': 4, 'W': 4, 'X': 4}"
INV-ZZ-0000230,SCH-ZZ-0000034,1034,Boeing 787,08/20/2024,08/20/2024,VNS,BOM,270,305,159,-111,146,27,54,81,108,30,18,12,61,38,23,89,46,43,125,57,68,"{'F': 16, 'P': 11}","{'C': 22, 'J': 16, 'Z': 16}","{'Q': 24, 'R': 16, 'S': 8, 'T': 8, 'H': 16, 'M': 8}","{'Y': 8, 'A': 8, 'B': 4, 'D': 4, 'E': 4, 'G': 8, 'I': 4, 'K': 8, 'L': 4, 'N': 4, 'O': 4, 'U': 8, 'V': 4, 'W': 4, 'X': 4}"
INV-ZZ-0000294,SCH-ZZ-0000098,1034,Boeing 787,08/20/2024,08/20/2024,VNS,BOM,270,288,121,-149,167,27,54,81,108,32,19,13,57,25,32,83,35,48,116,42,74,"{'F': 16, 'P': 11}","{'C': 22, 'J': 16, 'Z': 16}","{'Q': 24, 'R': 16, 'S': 8, 'T': 8, 'H': 16, 'M': 8}","{'Y': 8, 'A': 8, 'B': 4, 'D': 4, 'E': 4, 'G': 8, 'I': 4, 'K': 8, 'L': 4, 'N': 4, 'O': 4, 'U': 8, 'V': 4, 'W': 4, 'X': 4}"
INV-ZZ-0000358,SCH-ZZ-0000162,1034,Boeing 787,08/20/2024,08/20/2024,VNS,BOM,270,285,228,-42,57,27,54,81,108,29,25,4,57,48,9,86,62,24,113,93,20,"{'F': 16, 'P': 11}","{'C': 22, 'J': 16, 'Z': 16}","{'Q': 24, 'R': 16, 'S': 8, 'T': 8, 'H': 16, 'M': 8}","{'Y': 8, 'A': 8, 'B': 4, 'D': 4, 'E': 4, 'G': 8, 'I': 4, 'K': 8, 'L': 4, 'N': 4, 'O': 4, 'U': 8, 'V': 4, 'W': 4, 'X': 4}"
INV-ZZ-0000231,SCH-ZZ-0000035,1035,Boeing 787,08/20/2024,08/20/2024,VNS,DUB,270,297,154,-116,143,27,54,81,108,29,20,9,58,22,36,88,69,19,122,43,79,"{'F': 16, 'P': 11}","{'C': 22, 'J': 16, 'Z': 16}","{'Q': 24, 'R': 16, 'S': 8, 'T': 8, 'H': 16, 'M': 8}","{'Y': 8, 'A': 8, 'B': 4, 'D': 4, 'E': 4, 'G': 8, 'I': 4, 'K': 8, 'L': 4, 'N': 4, 'O': 4, 'U': 8, 'V': 4, 'W': 4, 'X': 4}"
INV-ZZ-0000295,SCH-ZZ-0000099,1035,Boeing 787,08/20/2024,08/20/2024,VNS,DUB,270,287,225,-45,62,27,54,81,108,30,18,12,58,37,21,90,62,28,109,108,1,"{'F': 16, 'P': 11}","{'C': 22, 'J': 16, 'Z': 16}","{'Q': 24, 'R': 16, 'S': 8, 'T': 8, 'H': 16, 'M': 8}","{'Y': 8, 'A': 8, 'B': 4, 'D': 4, 'E': 4, 'G': 8, 'I': 4, 'K': 8, 'L': 4, 'N': 4, 'O': 4, 'U': 8, 'V': 4, 'W': 4, 'X': 4}"
INV-ZZ-0000359,SCH-ZZ-0000163,1035,Boeing 787,08/20/2024,08/20/2024,VNS,DUB,270,279,200,-70,79,27,54,81,108,29,22,7,55,24,31,84,55,29,111,99,12,"{'F': 16, 'P': 11}","{'C': 22, 'J': 16, 'Z': 16}","{'Q': 24, 'R': 16, 'S': 8, 'T': 8, 'H': 16, 'M': 8}","{'Y': 8, 'A': 8, 'B': 4, 'D': 4, 'E': 4, 'G': 8, 'I': 4, 'K': 8, 'L': 4, 'N': 4, 'O': 4, 'U': 8, 'V': 4, 'W': 4, 'X': 4}"
INV-ZZ-0000233,SCH-ZZ-0000037,1037,Boeing 787,08/20/2024,08/20/2024,VNS,JFK,270,305,160,-110,145,27,54,81,108,32,19,13,59,49,10,86,48,38,128,44,84,"{'F': 16, 'P': 11}","{'C': 22, 'J': 16, 'Z': 16}","{'Q': 24, 'R': 16, 'S': 8, 'T': 8, 'H': 16, 'M': 8}","{'Y': 8, 'A': 8, 'B': 4, 'D': 4, 'E': 4, 'G': 8, 'I': 4, 'K': 8, 'L': 4, 'N': 4, 'O': 4, 'U': 8, 'V': 4, 'W': 4, 'X': 4}"
INV-ZZ-0000297,SCH-ZZ-0000101,1037,Boeing 787,08/20/2024,08/20/2024,VNS,JFK,270,297,161,-109,136,27,54,81,108,32,15,17,61,25,36,85,61,24,119,60,59,"{'F': 16, 'P': 11}","{'C': 22, 'J': 16, 'Z': 16}","{'Q': 24, 'R': 16, 'S': 8, 'T': 8, 'H': 16, 'M': 8}","{'Y': 8, 'A': 8, 'B': 4, 'D': 4, 'E': 4, 'G': 8, 'I': 4, 'K': 8, 'L': 4, 'N': 4, 'O': 4, 'U': 8, 'V': 4, 'W': 4, 'X': 4}"
INV-ZZ-0000361,SCH-ZZ-0000165,1037,Boeing 787,08/20/2024,08/20/2024,VNS,JFK,270,295,192,-78,103,27,54,81,108,32,19,13,61,37,24,89,45,44,113,91,22,"{'F': 16, 'P': 11}","{'C': 22, 'J': 16, 'Z': 16}","{'Q': 24, 'R': 16, 'S': 8, 'T': 8, 'H': 16, 'M': 8}","{'Y': 8, 'A': 8, 'B': 4, 'D': 4, 'E': 4, 'G': 8, 'I': 4, 'K': 8, 'L': 4, 'N': 4, 'O': 4, 'U': 8, 'V': 4, 'W': 4, 'X': 4}"
INV-ZZ-0000234,SCH-ZZ-0000038,1038,Boeing 787,08/20/2024,08/20/2024,VNS,DEL,270,303,187,-83,116,27,54,81,108,31,14,17,60,24,36,88,65,23,124,84,40,"{'F': 16, 'P': 11}","{'C': 22, 'J': 16, 'Z': 16}","{'Q': 24, 'R': 16, 'S': 8, 'T': 8, 'H': 16, 'M': 8}","{'Y': 8, 'A': 8, 'B': 4, 'D': 4, 'E': 4, 'G': 8, 'I': 4, 'K': 8, 'L': 4, 'N': 4, 'O': 4, 'U': 8, 'V': 4, 'W': 4, 'X': 4}"
INV-ZZ-0000298,SCH-ZZ-0000102,1038,Boeing 787,08/20/2024,08/20/2024,VNS,DEL,270,284,243,-27,41,27,54,81,108,29,12,17,55,47,8,91,80,11,109,104,5,"{'F': 16, 'P': 11}","{'C': 22, 'J': 16, 'Z': 16}","{'Q': 24, 'R': 16, 'S': 8, 'T': 8, 'H': 16, 'M': 8}","{'Y': 8, 'A': 8, 'B': 4, 'D': 4, 'E': 4, 'G': 8, 'I': 4, 'K': 8, 'L': 4, 'N': 4, 'O': 4, 'U': 8, 'V': 4, 'W': 4, 'X': 4}"
INV-ZZ-0000362,SCH-ZZ-0000166,1038,Boeing 787,08/20/2024,08/20/2024,VNS,DEL,270,291,188,-82,103,27,54,81,108,30,22,8,57,49,8,85,69,16,119,48,71,"{'F': 16, 'P': 11}","{'C': 22, 'J': 16, 'Z': 16}","{'Q': 24, 'R': 16, 'S': 8, 'T': 8, 'H': 16, 'M': 8}","{'Y': 8, 'A': 8, 'B': 4, 'D': 4, 'E': 4, 'G': 8, 'I': 4, 'K': 8, 'L': 4, 'N': 4, 'O': 4, 'U': 8, 'V': 4, 'W': 4, 'X': 4}"
INV-ZZ-0000235,SCH-ZZ-0000039,1039,Boeing 787,08/20/2024,08/20/2024,VNS,LAX,270,284,183,-87,101,27,54,81,108,28,14,14,56,33,23,83,79,4,117,57,60,"{'F': 16, 'P': 11}","{'C': 22, 'J': 16, 'Z': 16}","{'Q': 24, 'R': 16, 'S': 8, 'T': 8, 'H': 16, 'M': 8}","{'Y': 8, 'A': 8, 'B': 4, 'D': 4, 'E': 4, 'G': 8, 'I': 4, 'K': 8, 'L': 4, 'N': 4, 'O': 4, 'U': 8, 'V': 4, 'W': 4, 'X': 4}"
INV-ZZ-0000299,SCH-ZZ-0000103,1039,Boeing 787,08/20/2024,08/20/2024,VNS,LAX,270,291,159,-111,132,27,54,81,108,28,19,9,59,23,36,85,75,10,119,42,77,"{'F': 16, 'P': 11}","{'C': 22, 'J': 16, 'Z': 16}","{'Q': 24, 'R': 16, 'S': 8, 'T': 8, 'H': 16, 'M': 8}","{'Y': 8, 'A': 8, 'B': 4, 'D': 4, 'E': 4, 'G': 8, 'I': 4, 'K': 8, 'L': 4, 'N': 4, 'O': 4, 'U': 8, 'V': 4, 'W': 4, 'X': 4}"
INV-ZZ-0000363,SCH-ZZ-0000167,1039,Boeing 787,08/20/2024,08/20/2024,VNS,LAX,270,295,181,-89,114,27,54,81,108,28,13,15,61,30,31,88,78,10,118,60,58,"{'F': 16, 'P': 11}","{'C': 22, 'J': 16, 'Z': 16}","{'Q': 24, 'R': 16, 'S': 8, 'T': 8, 'H': 16, 'M': 8}","{'Y': 8, 'A': 8, 'B': 4, 'D': 4, 'E': 4, 'G': 8, 'I': 4, 'K': 8, 'L': 4, 'N': 4, 'O': 4, 'U': 8, 'V': 4, 'W': 4, 'X': 4}"
INV-ZZ-0000236,SCH-ZZ-0000040,1040,Boeing 787,08/20/2024,08/20/2024,JFK,MAA,270,289,179,-91,110,27,54,81,108,28,26,2,61,22,39,83,67,16,117,64,53,"{'F': 16, 'P': 11}","{'C': 22, 'J': 16, 'Z': 16}","{'Q': 24, 'R': 16, 'S': 8, 'T': 8, 'H': 16, 'M': 8}","{'Y': 8, 'A': 8, 'B': 4, 'D': 4, 'E': 4, 'G': 8, 'I': 4, 'K': 8, 'L': 4, 'N': 4, 'O': 4, 'U': 8, 'V': 4, 'W': 4, 'X': 4}"
INV-ZZ-0000300,SCH-ZZ-0000104,1040,Boeing 787,08/20/2024,08/20/2024,JFK,MAA,270,289,192,-78,97,27,54,81,108,29,25,4,60,24,36,89,64,25,111,79,32,"{'F': 16, 'P': 11}","{'C': 22, 'J': 16, 'Z': 16}","{'Q': 24, 'R': 16, 'S': 8, 'T': 8, 'H': 16, 'M': 8}","{'Y': 8, 'A': 8, 'B': 4, 'D': 4, 'E': 4, 'G': 8, 'I': 4, 'K': 8, 'L': 4, 'N': 4, 'O': 4, 'U': 8, 'V': 4, 'W': 4, 'X': 4}"
INV-ZZ-0000364,SCH-ZZ-0000168,1040,Boeing 787,08/20/2024,08/20/2024,JFK,MAA,270,291,237,-33,54,27,54,81,108,28,24,4,59,45,14,91,69,22,113,99,14,"{'F': 16, 'P': 11}","{'C': 22, 'J': 16, 'Z': 16}","{'Q': 24, 'R': 16, 'S': 8, 'T': 8, 'H': 16, 'M': 8}","{'Y': 8, 'A': 8, 'B': 4, 'D': 4, 'E': 4, 'G': 8, 'I': 4, 'K': 8, 'L': 4, 'N': 4, 'O': 4, 'U': 8, 'V': 4, 'W': 4, 'X': 4}"
INV-ZZ-0000237,SCH-ZZ-0000041,1041,Boeing 787,08/20/2024,08/20/2024,JFK,BLR,270,282,227,-43,55,27,54,81,108,32,19,13,55,54,1,84,69,15,111,85,26,"{'F': 16, 'P': 11}","{'C': 22, 'J': 16, 'Z': 16}","{'Q': 24, 'R': 16, 'S': 8, 'T': 8, 'H': 16, 'M': 8}","{'Y': 8, 'A': 8, 'B': 4, 'D': 4, 'E': 4, 'G': 8, 'I': 4, 'K': 8, 'L': 4, 'N': 4, 'O': 4, 'U': 8, 'V': 4, 'W': 4, 'X': 4}"
INV-ZZ-0000301,SCH-ZZ-0000105,1041,Boeing 787,08/20/2024,08/20/2024,JFK,BLR,270,289,223,-47,66,27,54,81,108,30,26,4,55,43,12,86,81,5,118,73,45,"{'F': 16, 'P': 11}","{'C': 22, 'J': 16, 'Z': 16}","{'Q': 24, 'R': 16, 'S': 8, 'T': 8, 'H': 16, 'M': 8}","{'Y': 8, 'A': 8, 'B': 4, 'D': 4, 'E': 4, 'G': 8, 'I': 4, 'K': 8, 'L': 4, 'N': 4, 'O': 4, 'U': 8, 'V': 4, 'W': 4, 'X': 4}"
INV-ZZ-0000365,SCH-ZZ-0000169,1041,Boeing 787,08/20/2024,08/20/2024,JFK,BLR,270,289,206,-64,83,27,54,81,108,30,11,19,56,40,16,83,72,11,120,83,37,"{'F': 16, 'P': 11}","{'C': 22, 'J': 16, 'Z': 16}","{'Q': 24, 'R': 16, 'S': 8, 'T': 8, 'H': 16, 'M': 8}","{'Y': 8, 'A': 8, 'B': 4, 'D': 4, 'E': 4, 'G': 8, 'I': 4, 'K': 8, 'L': 4, 'N': 4, 'O': 4, 'U': 8, 'V': 4, 'W': 4, 'X': 4}"
INV-ZZ-0000238,SCH-ZZ-0000042,1042,Boeing 787,08/20/2024,08/20/2024,JFK,BOM,270,296,196,-74,100,27,54,81,108,29,20,9,57,34,23,85,60,25,125,82,43,"{'F': 16, 'P': 11}","{'C': 22, 'J': 16, 'Z': 16}","{'Q': 24, 'R': 16, 'S': 8, 'T': 8, 'H': 16, 'M': 8}","{'Y': 8, 'A': 8, 'B': 4, 'D': 4, 'E': 4, 'G': 8, 'I': 4, 'K': 8, 'L': 4, 'N': 4, 'O': 4, 'U': 8, 'V': 4, 'W': 4, 'X': 4}"
INV-ZZ-0000302,SCH-ZZ-0000106,1042,Boeing 787,08/20/2024,08/20/2024,JFK,BOM,270,300,213,-57,87,27,54,81,108,30,10,20,58,50,8,91,47,44,121,106,15,"{'F': 16, 'P': 11}","{'C': 22, 'J': 16, 'Z': 16}","{'Q': 24, 'R': 16, 'S': 8, 'T': 8, 'H': 16, 'M': 8}","{'Y': 8, 'A': 8, 'B': 4, 'D': 4, 'E': 4, 'G': 8, 'I': 4, 'K': 8, 'L': 4, 'N': 4, 'O': 4, 'U': 8, 'V': 4, 'W': 4, 'X': 4}"
INV-ZZ-0000366,SCH-ZZ-0000170,1042,Boeing 787,08/20/2024,08/20/2024,JFK,BOM,270,282,159,-111,123,27,54,81,108,28,10,18,59,33,26,85,57,28,110,59,51,"{'F': 16, 'P': 11}","{'C': 22, 'J': 16, 'Z': 16}","{'Q': 24, 'R': 16, 'S': 8, 'T': 8, 'H': 16, 'M': 8}","{'Y': 8, 'A': 8, 'B': 4, 'D': 4, 'E': 4, 'G': 8, 'I': 4, 'K': 8, 'L': 4, 'N': 4, 'O': 4, 'U': 8, 'V': 4, 'W': 4, 'X': 4}"
INV-ZZ-0000239,SCH-ZZ-0000043,1043,Boeing 787,08/20/2024,08/20/2024,JFK,DUB,270,293,147,-123,146,27,54,81,108,32,13,19,60,21,39,83,48,35,118,65,53,"{'F': 16, 'P': 11}","{'C': 22, 'J': 16, 'Z': 16}","{'Q': 24, 'R': 16, 'S': 8, 'T': 8, 'H': 16, 'M': 8}","{'Y': 8, 'A': 8, 'B': 4, 'D': 4, 'E': 4, 'G': 8, 'I': 4, 'K': 8, 'L': 4, 'N': 4, 'O': 4, 'U': 8, 'V': 4, 'W': 4, 'X': 4}"
INV-ZZ-0000303,SCH-ZZ-0000107,1043,Boeing 787,08/20/2024,08/20/2024,JFK,DUB,270,306,171,-99,135,27,54,81,108,30,20,10,60,20,40,90,51,39,126,80,46,"{'F': 16, 'P': 11}","{'C': 22, 'J': 16, 'Z': 16}","{'Q': 24, 'R': 16, 'S': 8, 'T': 8, 'H': 16, 'M': 8}","{'Y': 8, 'A': 8, 'B': 4, 'D': 4, 'E': 4, 'G': 8, 'I': 4, 'K': 8, 'L': 4, 'N': 4, 'O': 4, 'U': 8, 'V': 4, 'W': 4, 'X': 4}"
INV-ZZ-0000367,SCH-ZZ-0000171,1043,Boeing 787,08/20/2024,08/20/2024,JFK,DUB,270,291,203,-67,88,27,54,81,108,30,19,11,56,29,27,82,59,23,123,96,27,"{'F': 16, 'P': 11}","{'C': 22, 'J': 16, 'Z': 16}","{'Q': 24, 'R': 16, 'S': 8, 'T': 8, 'H': 16, 'M': 8}","{'Y': 8, 'A': 8, 'B': 4, 'D': 4, 'E': 4, 'G': 8, 'I': 4, 'K': 8, 'L': 4, 'N': 4, 'O': 4, 'U': 8, 'V': 4, 'W': 4, 'X': 4}"
INV-ZZ-0000240,SCH-ZZ-0000044,1044,Boeing 787,08/20/2024,08/20/2024,JFK,VNS,270,298,194,-76,104,27,54,81,108,31,11,20,55,48,7,86,72,14,126,63,63,"{'F': 16, 'P': 11}","{'C': 22, 'J': 16, 'Z': 16}","{'Q': 24, 'R': 16, 'S': 8, 'T': 8, 'H': 16, 'M': 8}","{'Y': 8, 'A': 8, 'B': 4, 'D': 4, 'E': 4, 'G': 8, 'I': 4, 'K': 8, 'L': 4, 'N': 4, 'O': 4, 'U': 8, 'V': 4, 'W': 4, 'X': 4}"
INV-ZZ-0000304,SCH-ZZ-0000108,1044,Boeing 787,08/20/2024,08/20/2024,JFK,VNS,270,294,188,-82,106,27,54,81,108,28,22,6,58,36,22,85,50,35,123,80,43,"{'F': 16, 'P': 11}","{'C': 22, 'J': 16, 'Z': 16}","{'Q': 24, 'R': 16, 'S': 8, 'T': 8, 'H': 16, 'M': 8}","{'Y': 8, 'A': 8, 'B': 4, 'D': 4, 'E': 4, 'G': 8, 'I': 4, 'K': 8, 'L': 4, 'N': 4, 'O': 4, 'U': 8, 'V': 4, 'W': 4, 'X': 4}"
INV-ZZ-0000368,SCH-ZZ-0000172,1044,Boeing 787,08/20/2024,08/20/2024,JFK,VNS,270,298,147,-123,151,27,54,81,108,29,14,15,56,28,28,89,58,31,124,47,77,"{'F': 16, 'P': 11}","{'C': 22, 'J': 16, 'Z': 16}","{'Q': 24, 'R': 16, 'S': 8, 'T': 8, 'H': 16, 'M': 8}","{'Y': 8, 'A': 8, 'B': 4, 'D': 4, 'E': 4, 'G': 8, 'I': 4, 'K': 8, 'L': 4, 'N': 4, 'O': 4, 'U': 8, 'V': 4, 'W': 4, 'X': 4}"
INV-ZZ-0000242,SCH-ZZ-0000046,1046,Boeing 787,08/20/2024,08/20/2024,JFK,DEL,270,296,201,-69,95,27,54,81,108,31,25,6,59,40,19,87,40,47,119,96,23,"{'F': 16, 'P': 11}","{'C': 22, 'J': 16, 'Z': 16}","{'Q': 24, 'R': 16, 'S': 8, 'T': 8, 'H': 16, 'M': 8}","{'Y': 8, 'A': 8, 'B': 4, 'D': 4, 'E': 4, 'G': 8, 'I': 4, 'K': 8, 'L': 4, 'N': 4, 'O': 4, 'U': 8, 'V': 4, 'W': 4, 'X': 4}"
INV-ZZ-0000306,SCH-ZZ-0000110,1046,Boeing 787,08/20/2024,08/20/2024,JFK,DEL,270,304,166,-104,138,27,54,81,108,32,25,7,58,31,27,86,70,16,128,40,88,"{'F': 16, 'P': 11}","{'C': 22, 'J': 16, 'Z': 16}","{'Q': 24, 'R': 16, 'S': 8, 'T': 8, 'H': 16, 'M': 8}","{'Y': 8, 'A': 8, 'B': 4, 'D': 4, 'E': 4, 'G': 8, 'I': 4, 'K': 8, 'L': 4, 'N': 4, 'O': 4, 'U': 8, 'V': 4, 'W': 4, 'X': 4}"
INV-ZZ-0000370,SCH-ZZ-0000174,1046,Boeing 787,08/20/2024,08/20/2024,JFK,DEL,270,285,230,-40,55,27,54,81,108,29,16,13,61,41,20,82,77,5,113,96,17,"{'F': 16, 'P': 11}","{'C': 22, 'J': 16, 'Z': 16}","{'Q': 24, 'R': 16, 'S': 8, 'T': 8, 'H': 16, 'M': 8}","{'Y': 8, 'A': 8, 'B': 4, 'D': 4, 'E': 4, 'G': 8, 'I': 4, 'K': 8, 'L': 4, 'N': 4, 'O': 4, 'U': 8, 'V': 4, 'W': 4, 'X': 4}"
INV-ZZ-0000243,SCH-ZZ-0000047,1047,Boeing 787,08/20/2024,08/20/2024,JFK,LAX,270,304,176,-94,128,27,54,81,108,29,11,18,61,49,12,91,52,39,123,64,59,"{'F': 16, 'P': 11}","{'C': 22, 'J': 16, 'Z': 16}","{'Q': 24, 'R': 16, 'S': 8, 'T': 8, 'H': 16, 'M': 8}","{'Y': 8, 'A': 8, 'B': 4, 'D': 4, 'E': 4, 'G': 8, 'I': 4, 'K': 8, 'L': 4, 'N': 4, 'O': 4, 'U': 8, 'V': 4, 'W': 4, 'X': 4}"
INV-ZZ-0000307,SCH-ZZ-0000111,1047,Boeing 787,08/20/2024,08/20/2024,JFK,LAX,270,304,176,-94,128,27,54,81,108,31,11,20,60,23,37,85,49,36,128,93,35,"{'F': 16, 'P': 11}","{'C': 22, 'J': 16, 'Z': 16}","{'Q': 24, 'R': 16, 'S': 8, 'T': 8, 'H': 16, 'M': 8}","{'Y': 8, 'A': 8, 'B': 4, 'D': 4, 'E': 4, 'G': 8, 'I': 4, 'K': 8, 'L': 4, 'N': 4, 'O': 4, 'U': 8, 'V': 4, 'W': 4, 'X': 4}"
INV-ZZ-0000371,SCH-ZZ-0000175,1047,Boeing 787,08/20/2024,08/20/2024,JFK,LAX,270,296,167,-103,129,27,54,81,108,30,23,7,59,45,14,84,37,47,123,62,61,"{'F': 16, 'P': 11}","{'C': 22, 'J': 16, 'Z': 16}","{'Q': 24, 'R': 16, 'S': 8, 'T': 8, 'H': 16, 'M': 8}","{'Y': 8, 'A': 8, 'B': 4, 'D': 4, 'E': 4, 'G': 8, 'I': 4, 'K': 8, 'L': 4, 'N': 4, 'O': 4, 'U': 8, 'V': 4, 'W': 4, 'X': 4}"
INV-ZZ-0000244,SCH-ZZ-0000048,1048,Boeing 787,08/20/2024,08/20/2024,DEL,MAA,270,296,229,-41,67,27,54,81,108,28,20,8,58,41,17,82,62,20,128,106,22,"{'F': 16, 'P': 11}","{'C': 22, 'J': 16, 'Z': 16}","{'Q': 24, 'R': 16, 'S': 8, 'T': 8, 'H': 16, 'M': 8}","{'Y': 8, 'A': 8, 'B': 4, 'D': 4, 'E': 4, 'G': 8, 'I': 4, 'K': 8, 'L': 4, 'N': 4, 'O': 4, 'U': 8, 'V': 4, 'W': 4, 'X': 4}"
INV-ZZ-0000308,SCH-ZZ-0000112,1048,Boeing 787,08/20/2024,08/20/2024,DEL,MAA,270,289,173,-97,116,27,54,81,108,32,19,13,58,35,23,86,69,17,113,50,63,"{'F': 16, 'P': 11}","{'C': 22, 'J': 16, 'Z': 16}","{'Q': 24, 'R': 16, 'S': 8, 'T': 8, 'H': 16, 'M': 8}","{'Y': 8, 'A': 8, 'B': 4, 'D': 4, 'E': 4, 'G': 8, 'I': 4, 'K': 8, 'L': 4, 'N': 4, 'O': 4, 'U': 8, 'V': 4, 'W': 4, 'X': 4}"
INV-ZZ-0000372,SCH-ZZ-0000176,1048,Boeing 787,08/20/2024,08/20/2024,DEL,MAA,270,283,188,-82,95,27,54,81,108,28,17,11,58,28,30,85,59,26,112,84,28,"{'F': 16, 'P': 11}","{'C': 22, 'J': 16, 'Z': 16}","{'Q': 24, 'R': 16, 'S': 8, 'T': 8, 'H': 16, 'M': 8}","{'Y': 8, 'A': 8, 'B': 4, 'D': 4, 'E': 4, 'G': 8, 'I': 4, 'K': 8, 'L': 4, 'N': 4, 'O': 4, 'U': 8, 'V': 4, 'W': 4, 'X': 4}"
INV-ZZ-0000245,SCH-ZZ-0000049,1049,Boeing 787,08/20/2024,08/20/2024,DEL,BLR,270,304,162,-108,142,27,54,81,108,31,27,4,56,31,25,91,35,56,126,69,57,"{'F': 16, 'P': 11}","{'C': 22, 'J': 16, 'Z': 16}","{'Q': 24, 'R': 16, 'S': 8, 'T': 8, 'H': 16, 'M': 8}","{'Y': 8, 'A': 8, 'B': 4, 'D': 4, 'E': 4, 'G': 8, 'I': 4, 'K': 8, 'L': 4, 'N': 4, 'O': 4, 'U': 8, 'V': 4, 'W': 4, 'X': 4}"
INV-ZZ-0000309,SCH-ZZ-0000113,1049,Boeing 787,08/20/2024,08/20/2024,DEL,BLR,270,296,195,-75,101,27,54,81,108,29,20,9,59,48,11,88,75,13,120,52,68,"{'F': 16, 'P': 11}","{'C': 22, 'J': 16, 'Z': 16}","{'Q': 24, 'R': 16, 'S': 8, 'T': 8, 'H': 16, 'M': 8}","{'Y': 8, 'A': 8, 'B': 4, 'D': 4, 'E': 4, 'G': 8, 'I': 4, 'K': 8, 'L': 4, 'N': 4, 'O': 4, 'U': 8, 'V': 4, 'W': 4, 'X': 4}"
INV-ZZ-0000373,SCH-ZZ-0000177,1049,Boeing 787,08/20/2024,08/20/2024,DEL,BLR,270,288,162,-108,126,27,54,81,108,31,19,12,57,46,11,91,41,50,109,56,53,"{'F': 16, 'P': 11}","{'C': 22, 'J': 16, 'Z': 16}","{'Q': 24, 'R': 16, 'S': 8, 'T': 8, 'H': 16, 'M': 8}","{'Y': 8, 'A': 8, 'B': 4, 'D': 4, 'E': 4, 'G': 8, 'I': 4, 'K': 8, 'L': 4, 'N': 4, 'O': 4, 'U': 8, 'V': 4, 'W': 4, 'X': 4}"
INV-ZZ-0000246,SCH-ZZ-0000050,1050,Boeing 787,08/20/2024,08/20/2024,DEL,BOM,270,285,203,-67,82,27,54,81,108,31,17,14,61,30,31,83,53,30,110,103,7,"{'F': 16, 'P': 11}","{'C': 22, 'J': 16, 'Z': 16}","{'Q': 24, 'R': 16, 'S': 8, 'T': 8, 'H': 16, 'M': 8}","{'Y': 8, 'A': 8, 'B': 4, 'D': 4, 'E': 4, 'G': 8, 'I': 4, 'K': 8, 'L': 4, 'N': 4, 'O': 4, 'U': 8, 'V': 4, 'W': 4, 'X': 4}"
INV-ZZ-0000310,SCH-ZZ-0000114,1050,Boeing 787,08/20/2024,08/20/2024,DEL,BOM,270,280,132,-138,148,27,54,81,108,28,19,9,56,20,36,86,42,44,110,51,59,"{'F': 16, 'P': 11}","{'C': 22, 'J': 16, 'Z': 16}","{'Q': 24, 'R': 16, 'S': 8, 'T': 8, 'H': 16, 'M': 8}","{'Y': 8, 'A': 8, 'B': 4, 'D': 4, 'E': 4, 'G': 8, 'I': 4, 'K': 8, 'L': 4, 'N': 4, 'O': 4, 'U': 8, 'V': 4, 'W': 4, 'X': 4}"
INV-ZZ-0000374,SCH-ZZ-0000178,1050,Boeing 787,08/20/2024,08/20/2024,DEL,BOM,270,290,171,-99,119,27,54,81,108,31,16,15,61,52,9,83,50,33,115,53,62,"{'F': 16, 'P': 11}","{'C': 22, 'J': 16, 'Z': 16}","{'Q': 24, 'R': 16, 'S': 8, 'T': 8, 'H': 16, 'M': 8}","{'Y': 8, 'A': 8, 'B': 4, 'D': 4, 'E': 4, 'G': 8, 'I': 4, 'K': 8, 'L': 4, 'N': 4, 'O': 4, 'U': 8, 'V': 4, 'W': 4, 'X': 4}"
INV-ZZ-0000247,SCH-ZZ-0000051,1051,Boeing 787,08/20/2024,08/20/2024,DEL,DUB,270,291,171,-99,120,27,54,81,108,29,17,12,57,33,24,82,81,1,123,40,83,"{'F': 16, 'P': 11}","{'C': 22, 'J': 16, 'Z': 16}","{'Q': 24, 'R': 16, 'S': 8, 'T': 8, 'H': 16, 'M': 8}","{'Y': 8, 'A': 8, 'B': 4, 'D': 4, 'E': 4, 'G': 8, 'I': 4, 'K': 8, 'L': 4, 'N': 4, 'O': 4, 'U': 8, 'V': 4, 'W': 4, 'X': 4}"
INV-ZZ-0000311,SCH-ZZ-0000115,1051,Boeing 787,08/20/2024,08/20/2024,DEL,DUB,270,287,191,-79,96,27,54,81,108,28,14,14,57,41,16,87,75,12,115,61,54,"{'F': 16, 'P': 11}","{'C': 22, 'J': 16, 'Z': 16}","{'Q': 24, 'R': 16, 'S': 8, 'T': 8, 'H': 16, 'M': 8}","{'Y': 8, 'A': 8, 'B': 4, 'D': 4, 'E': 4, 'G': 8, 'I': 4, 'K': 8, 'L': 4, 'N': 4, 'O': 4, 'U': 8, 'V': 4, 'W': 4, 'X': 4}"
INV-ZZ-0000375,SCH-ZZ-0000179,1051,Boeing 787,08/20/2024,08/20/2024,DEL,DUB,270,292,157,-113,135,27,54,81,108,32,19,13,55,40,15,90,39,51,115,59,56,"{'F': 16, 'P': 11}","{'C': 22, 'J': 16, 'Z': 16}","{'Q': 24, 'R': 16, 'S': 8, 'T': 8, 'H': 16, 'M': 8}","{'Y': 8, 'A': 8, 'B': 4, 'D': 4, 'E': 4, 'G': 8, 'I': 4, 'K': 8, 'L': 4, 'N': 4, 'O': 4, 'U': 8, 'V': 4, 'W': 4, 'X': 4}"
INV-ZZ-0000248,SCH-ZZ-0000052,1052,Boeing 787,08/20/2024,08/20/2024,DEL,VNS,270,279,186,-84,93,27,54,81,108,28,23,5,57,35,22,82,64,18,112,64,48,"{'F': 16, 'P': 11}","{'C': 22, 'J': 16, 'Z': 16}","{'Q': 24, 'R': 16, 'S': 8, 'T': 8, 'H': 16, 'M': 8}","{'Y': 8, 'A': 8, 'B': 4, 'D': 4, 'E': 4, 'G': 8, 'I': 4, 'K': 8, 'L': 4, 'N': 4, 'O': 4, 'U': 8, 'V': 4, 'W': 4, 'X': 4}"
INV-ZZ-0000312,SCH-ZZ-0000116,1052,Boeing 787,08/20/2024,08/20/2024,DEL,VNS,270,287,206,-64,81,27,54,81,108,31,19,12,61,52,9,85,78,7,110,57,53,"{'F': 16, 'P': 11}","{'C': 22, 'J': 16, 'Z': 16}","{'Q': 24, 'R': 16, 'S': 8, 'T': 8, 'H': 16, 'M': 8}","{'Y': 8, 'A': 8, 'B': 4, 'D': 4, 'E': 4, 'G': 8, 'I': 4, 'K': 8, 'L': 4, 'N': 4, 'O': 4, 'U': 8, 'V': 4, 'W': 4, 'X': 4}"
INV-ZZ-0000376,SCH-ZZ-0000180,1052,Boeing 787,08/20/2024,08/20/2024,DEL,VNS,270,305,206,-64,99,27,54,81,108,32,17,15,61,54,7,91,60,31,121,75,46,"{'F': 16, 'P': 11}","{'C': 22, 'J': 16, 'Z': 16}","{'Q': 24, 'R': 16, 'S': 8, 'T': 8, 'H': 16, 'M': 8}","{'Y': 8, 'A': 8, 'B': 4, 'D': 4, 'E': 4, 'G': 8, 'I': 4, 'K': 8, 'L': 4, 'N': 4, 'O': 4, 'U': 8, 'V': 4, 'W': 4, 'X': 4}"
INV-ZZ-0000249,SCH-ZZ-0000053,1053,Boeing 787,08/20/2024,08/20/2024,DEL,JFK,270,280,204,-66,76,27,54,81,108,30,25,5,58,46,12,82,37,45,110,96,14,"{'F': 16, 'P': 11}","{'C': 22, 'J': 16, 'Z': 16}","{'Q': 24, 'R': 16, 'S': 8, 'T': 8, 'H': 16, 'M': 8}","{'Y': 8, 'A': 8, 'B': 4, 'D': 4, 'E': 4, 'G': 8, 'I': 4, 'K': 8, 'L': 4, 'N': 4, 'O': 4, 'U': 8, 'V': 4, 'W': 4, 'X': 4}"
INV-ZZ-0000313,SCH-ZZ-0000117,1053,Boeing 787,08/20/2024,08/20/2024,DEL,JFK,270,295,197,-73,98,27,54,81,108,29,24,5,58,42,16,87,38,49,121,93,28,"{'F': 16, 'P': 11}","{'C': 22, 'J': 16, 'Z': 16}","{'Q': 24, 'R': 16, 'S': 8, 'T': 8, 'H': 16, 'M': 8}","{'Y': 8, 'A': 8, 'B': 4, 'D': 4, 'E': 4, 'G': 8, 'I': 4, 'K': 8, 'L': 4, 'N': 4, 'O': 4, 'U': 8, 'V': 4, 'W': 4, 'X': 4}"
INV-ZZ-0000377,SCH-ZZ-0000181,1053,Boeing 787,08/20/2024,08/20/2024,DEL,JFK,270,299,185,-85,114,27,54,81,108,30,15,15,60,25,35,91,44,47,118,101,17,"{'F': 16, 'P': 11}","{'C': 22, 'J': 16, 'Z': 16}","{'Q': 24, 'R': 16, 'S': 8, 'T': 8, 'H': 16, 'M': 8}","{'Y': 8, 'A': 8, 'B': 4, 'D': 4, 'E': 4, 'G': 8, 'I': 4, 'K': 8, 'L': 4, 'N': 4, 'O': 4, 'U': 8, 'V': 4, 'W': 4, 'X': 4}"
INV-ZZ-0000251,SCH-ZZ-0000055,1055,Boeing 787,08/20/2024,08/20/2024,DEL,LAX,270,289,188,-82,101,27,54,81,108,32,17,15,55,24,31,87,53,34,115,94,21,"{'F': 16, 'P': 11}","{'C': 22, 'J': 16, 'Z': 16}","{'Q': 24, 'R': 16, 'S': 8, 'T': 8, 'H': 16, 'M': 8}","{'Y': 8, 'A': 8, 'B': 4, 'D': 4, 'E': 4, 'G': 8, 'I': 4, 'K': 8, 'L': 4, 'N': 4, 'O': 4, 'U': 8, 'V': 4, 'W': 4, 'X': 4}"
INV-ZZ-0000315,SCH-ZZ-0000119,1055,Boeing 787,08/20/2024,08/20/2024,DEL,LAX,270,294,200,-70,94,27,54,81,108,32,22,10,58,32,26,86,54,32,118,92,26,"{'F': 16, 'P': 11}","{'C': 22, 'J': 16, 'Z': 16}","{'Q': 24, 'R': 16, 'S': 8, 'T': 8, 'H': 16, 'M': 8}","{'Y': 8, 'A': 8, 'B': 4, 'D': 4, 'E': 4, 'G': 8, 'I': 4, 'K': 8, 'L': 4, 'N': 4, 'O': 4, 'U': 8, 'V': 4, 'W': 4, 'X': 4}"
INV-ZZ-0000379,SCH-ZZ-0000183,1055,Boeing 787,08/20/2024,08/20/2024,DEL,LAX,270,297,198,-72,99,27,54,81,108,32,23,9,58,20,38,83,49,34,124,106,18,"{'F': 16, 'P': 11}","{'C': 22, 'J': 16, 'Z': 16}","{'Q': 24, 'R': 16, 'S': 8, 'T': 8, 'H': 16, 'M': 8}","{'Y': 8, 'A': 8, 'B': 4, 'D': 4, 'E': 4, 'G': 8, 'I': 4, 'K': 8, 'L': 4, 'N': 4, 'O': 4, 'U': 8, 'V': 4, 'W': 4, 'X': 4}"
INV-ZZ-0000252,SCH-ZZ-0000056,1056,Boeing 787,08/20/2024,08/20/2024,LAX,MAA,270,296,179,-91,117,27,54,81,108,32,27,5,60,28,32,86,72,14,118,52,66,"{'F': 16, 'P': 11}","{'C': 22, 'J': 16, 'Z': 16}","{'Q': 24, 'R': 16, 'S': 8, 'T': 8, 'H': 16, 'M': 8}","{'Y': 8, 'A': 8, 'B': 4, 'D': 4, 'E': 4, 'G': 8, 'I': 4, 'K': 8, 'L': 4, 'N': 4, 'O': 4, 'U': 8, 'V': 4, 'W': 4, 'X': 4}"
INV-ZZ-0000316,SCH-ZZ-0000120,1056,Boeing 787,08/20/2024,08/20/2024,LAX,MAA,270,296,178,-92,118,27,54,81,108,29,15,14,61,24,37,82,54,28,124,85,39,"{'F': 16, 'P': 11}","{'C': 22, 'J': 16, 'Z': 16}","{'Q': 24, 'R': 16, 'S': 8, 'T': 8, 'H': 16, 'M': 8}","{'Y': 8, 'A': 8, 'B': 4, 'D': 4, 'E': 4, 'G': 8, 'I': 4, 'K': 8, 'L': 4, 'N': 4, 'O': 4, 'U': 8, 'V': 4, 'W': 4, 'X': 4}"
INV-ZZ-0000380,SCH-ZZ-0000184,1056,Boeing 787,08/20/2024,08/20/2024,LAX,MAA,270,297,225,-45,72,27,54,81,108,31,14,17,59,44,15,83,68,15,124,99,25,"{'F': 16, 'P': 11}","{'C': 22, 'J': 16, 'Z': 16}","{'Q': 24, 'R': 16, 'S': 8, 'T': 8, 'H': 16, 'M': 8}","{'Y': 8, 'A': 8, 'B': 4, 'D': 4, 'E': 4, 'G': 8, 'I': 4, 'K': 8, 'L': 4, 'N': 4, 'O': 4, 'U': 8, 'V': 4, 'W': 4, 'X': 4}"
INV-ZZ-0000253,SCH-ZZ-0000057,1057,Boeing 787,08/20/2024,08/20/2024,LAX,BLR,270,294,201,-69,93,27,54,81,108,28,17,11,56,53,3,90,70,20,120,61,59,"{'F': 16, 'P': 11}","{'C': 22, 'J': 16, 'Z': 16}","{'Q': 24, 'R': 16, 'S': 8, 'T': 8, 'H': 16, 'M': 8}","{'Y': 8, 'A': 8, 'B': 4, 'D': 4, 'E': 4, 'G': 8, 'I': 4, 'K': 8, 'L': 4, 'N': 4, 'O': 4, 'U': 8, 'V': 4, 'W': 4, 'X': 4}"
INV-ZZ-0000317,SCH-ZZ-0000121,1057,Boeing 787,08/20/2024,08/20/2024,LAX,BLR,270,299,168,-102,131,27,54,81,108,32,10,22,56,31,25,91,38,53,120,89,31,"{'F': 16, 'P': 11}","{'C': 22, 'J': 16, 'Z': 16}","{'Q': 24, 'R': 16, 'S': 8, 'T': 8, 'H': 16, 'M': 8}","{'Y': 8, 'A': 8, 'B': 4, 'D': 4, 'E': 4, 'G': 8, 'I': 4, 'K': 8, 'L': 4, 'N': 4, 'O': 4, 'U': 8, 'V': 4, 'W': 4, 'X': 4}"
INV-ZZ-0000381,SCH-ZZ-0000185,1057,Boeing 787,08/20/2024,08/20/2024,LAX,BLR,270,301,169,-101,132,27,54,81,108,28,10,18,61,35,26,86,65,21,126,59,67,"{'F': 16, 'P': 11}","{'C': 22, 'J': 16, 'Z': 16}","{'Q': 24, 'R': 16, 'S': 8, 'T': 8, 'H': 16, 'M': 8}","{'Y': 8, 'A': 8, 'B': 4, 'D': 4, 'E': 4, 'G': 8, 'I': 4, 'K': 8, 'L': 4, 'N': 4, 'O': 4, 'U': 8, 'V': 4, 'W': 4, 'X': 4}"
INV-ZZ-0000254,SCH-ZZ-0000058,1058,Boeing 787,08/20/2024,08/20/2024,LAX,BOM,270,294,169,-101,125,27,54,81,108,32,10,22,55,38,17,90,54,36,117,67,50,"{'F': 16, 'P': 11}","{'C': 22, 'J': 16, 'Z': 16}","{'Q': 24, 'R': 16, 'S': 8, 'T': 8, 'H': 16, 'M': 8}","{'Y': 8, 'A': 8, 'B': 4, 'D': 4, 'E': 4, 'G': 8, 'I': 4, 'K': 8, 'L': 4, 'N': 4, 'O': 4, 'U': 8, 'V': 4, 'W': 4, 'X': 4}"
INV-ZZ-0000318,SCH-ZZ-0000122,1058,Boeing 787,08/20/2024,08/20/2024,LAX,BOM,270,286,239,-31,47,27,54,81,108,28,27,1,58,50,8,85,81,4,115,81,34,"{'F': 16, 'P': 11}","{'C': 22, 'J': 16, 'Z': 16}","{'Q': 24, 'R': 16, 'S': 8, 'T': 8, 'H': 16, 'M': 8}","{'Y': 8, 'A': 8, 'B': 4, 'D': 4, 'E': 4, 'G': 8, 'I': 4, 'K': 8, 'L': 4, 'N': 4, 'O': 4, 'U': 8, 'V': 4, 'W': 4, 'X': 4}"
INV-ZZ-0000382,SCH-ZZ-0000186,1058,Boeing 787,08/20/2024,08/20/2024,LAX,BOM,270,287,163,-107,124,27,54,81,108,30,18,12,60,38,22,84,45,39,113,62,51,"{'F': 16, 'P': 11}","{'C': 22, 'J': 16, 'Z': 16}","{'Q': 24, 'R': 16, 'S': 8, 'T': 8, 'H': 16, 'M': 8}","{'Y': 8, 'A': 8, 'B': 4, 'D': 4, 'E': 4, 'G': 8, 'I': 4, 'K': 8, 'L': 4, 'N': 4, 'O': 4, 'U': 8, 'V': 4, 'W': 4, 'X': 4}"
INV-ZZ-0000255,SCH-ZZ-0000059,1059,Boeing 787,08/20/2024,08/20/2024,LAX,DUB,270,289,186,-84,103,27,54,81,108,31,27,4,58,28,30,83,50,33,117,81,36,"{'F': 16, 'P': 11}","{'C': 22, 'J': 16, 'Z': 16}","{'Q': 24, 'R': 16, 'S': 8, 'T': 8, 'H': 16, 'M': 8}","{'Y': 8, 'A': 8, 'B': 4, 'D': 4, 'E': 4, 'G': 8, 'I': 4, 'K': 8, 'L': 4, 'N': 4, 'O': 4, 'U': 8, 'V': 4, 'W': 4, 'X': 4}"
INV-ZZ-0000319,SCH-ZZ-0000123,1059,Boeing 787,08/20/2024,08/20/2024,LAX,DUB,270,292,148,-122,144,27,54,81,108,32,20,12,55,43,12,89,41,48,116,44,72,"{'F': 16, 'P': 11}","{'C': 22, 'J': 16, 'Z': 16}","{'Q': 24, 'R': 16, 'S': 8, 'T': 8, 'H': 16, 'M': 8}","{'Y': 8, 'A': 8, 'B': 4, 'D': 4, 'E': 4, 'G': 8, 'I': 4, 'K': 8, 'L': 4, 'N': 4, 'O': 4, 'U': 8, 'V': 4, 'W': 4, 'X': 4}"
INV-ZZ-0000383,SCH-ZZ-0000187,1059,Boeing 787,08/20/2024,08/20/2024,LAX,DUB,270,293,165,-105,128,27,54,81,108,30,12,18,56,24,32,86,56,30,121,73,48,"{'F': 16, 'P': 11}","{'C': 22, 'J': 16, 'Z': 16}","{'Q': 24, 'R': 16, 'S': 8, 'T': 8, 'H': 16, 'M': 8}","{'Y': 8, 'A': 8, 'B': 4, 'D': 4, 'E': 4, 'G': 8, 'I': 4, 'K': 8, 'L': 4, 'N': 4, 'O': 4, 'U': 8, 'V': 4, 'W': 4, 'X': 4}"
INV-ZZ-0000256,SCH-ZZ-0000060,1060,Boeing 787,08/20/2024,08/20/2024,LAX,VNS,270,293,211,-59,82,27,54,81,108,32,13,19,60,44,16,86,67,19,115,87,28,"{'F': 16, 'P': 11}","{'C': 22, 'J': 16, 'Z': 16}","{'Q': 24, 'R': 16, 'S': 8, 'T': 8, 'H': 16, 'M': 8}","{'Y': 8, 'A': 8, 'B': 4, 'D': 4, 'E': 4, 'G': 8, 'I': 4, 'K': 8, 'L': 4, 'N': 4, 'O': 4, 'U': 8, 'V': 4, 'W': 4, 'X': 4}"
INV-ZZ-0000320,SCH-ZZ-0000124,1060,Boeing 787,08/20/2024,08/20/2024,LAX,VNS,270,283,151,-119,132,27,54,81,108,28,10,18,59,38,21,83,59,24,113,44,69,"{'F': 16, 'P': 11}","{'C': 22, 'J': 16, 'Z': 16}","{'Q': 24, 'R': 16, 'S': 8, 'T': 8, 'H': 16, 'M': 8}","{'Y': 8, 'A': 8, 'B': 4, 'D': 4, 'E': 4, 'G': 8, 'I': 4, 'K': 8, 'L': 4, 'N': 4, 'O': 4, 'U': 8, 'V': 4, 'W': 4, 'X': 4}"
INV-ZZ-0000384,SCH-ZZ-0000188,1060,Boeing 787,08/20/2024,08/20/2024,LAX,VNS,270,288,195,-75,93,27,54,81,108,29,10,19,59,23,36,83,74,9,117,88,29,"{'F': 16, 'P': 11}","{'C': 22, 'J': 16, 'Z': 16}","{'Q': 24, 'R': 16, 'S': 8, 'T': 8, 'H': 16, 'M': 8}","{'Y': 8, 'A': 8, 'B': 4, 'D': 4, 'E': 4, 'G': 8, 'I': 4, 'K': 8, 'L': 4, 'N': 4, 'O': 4, 'U': 8, 'V': 4, 'W': 4, 'X': 4}"
INV-ZZ-0000257,SCH-ZZ-0000061,1061,Boeing 787,08/20/2024,08/20/2024,LAX,JFK,270,288,233,-37,55,27,54,81,108,31,25,6,59,39,20,83,78,5,115,91,24,"{'F': 16, 'P': 11}","{'C': 22, 'J': 16, 'Z': 16}","{'Q': 24, 'R': 16, 'S': 8, 'T': 8, 'H': 16, 'M': 8}","{'Y': 8, 'A': 8, 'B': 4, 'D': 4, 'E': 4, 'G': 8, 'I': 4, 'K': 8, 'L': 4, 'N': 4, 'O': 4, 'U': 8, 'V': 4, 'W': 4, 'X': 4}"
INV-ZZ-0000321,SCH-ZZ-0000125,1061,Boeing 787,08/20/2024,08/20/2024,LAX,JFK,270,300,198,-72,102,27,54,81,108,32,20,12,60,34,26,83,63,20,125,81,44,"{'F': 16, 'P': 11}","{'C': 22, 'J': 16, 'Z': 16}","{'Q': 24, 'R': 16, 'S': 8, 'T': 8, 'H': 16, 'M': 8}","{'Y': 8, 'A': 8, 'B': 4, 'D': 4, 'E': 4, 'G': 8, 'I': 4, 'K': 8, 'L': 4, 'N': 4, 'O': 4, 'U': 8, 'V': 4, 'W': 4, 'X': 4}"
INV-ZZ-0000385,SCH-ZZ-0000189,1061,Boeing 787,08/20/2024,08/20/2024,LAX,JFK,270,299,209,-61,90,27,54,81,108,31,20,11,61,32,29,85,51,34,122,106,16,"{'F': 16, 'P': 11}","{'C': 22, 'J': 16, 'Z': 16}","{'Q': 24, 'R': 16, 'S': 8, 'T': 8, 'H': 16, 'M': 8}","{'Y': 8, 'A': 8, 'B': 4, 'D': 4, 'E': 4, 'G': 8, 'I': 4, 'K': 8, 'L': 4, 'N': 4, 'O': 4, 'U': 8, 'V': 4, 'W': 4, 'X': 4}"
INV-ZZ-0000258,SCH-ZZ-0000062,1062,Boeing 787,08/20/2024,08/20/2024,LAX,DEL,270,288,150,-120,138,27,54,81,108,29,12,17,55,20,35,87,57,30,117,61,56,"{'F': 16, 'P': 11}","{'C': 22, 'J': 16, 'Z': 16}","{'Q': 24, 'R': 16, 'S': 8, 'T': 8, 'H': 16, 'M': 8}","{'Y': 8, 'A': 8, 'B': 4, 'D': 4, 'E': 4, 'G': 8, 'I': 4, 'K': 8, 'L': 4, 'N': 4, 'O': 4, 'U': 8, 'V': 4, 'W': 4, 'X': 4}"
INV-ZZ-0000322,SCH-ZZ-0000126,1062,Boeing 787,08/20/2024,08/20/2024,LAX,DEL,270,282,225,-45,57,27,54,81,108,28,27,1,55,44,11,87,77,10,112,77,35,"{'F': 16, 'P': 11}","{'C': 22, 'J': 16, 'Z': 16}","{'Q': 24, 'R': 16, 'S': 8, 'T': 8, 'H': 16, 'M': 8}","{'Y': 8, 'A': 8, 'B': 4, 'D': 4, 'E': 4, 'G': 8, 'I': 4, 'K': 8, 'L': 4, 'N': 4, 'O': 4, 'U': 8, 'V': 4, 'W': 4, 'X': 4}"
INV-ZZ-0000386,SCH-ZZ-0000190,1062,Boeing 787,08/20/2024,08/20/2024,LAX,DEL,270,289,222,-48,67,27,54,81,108,30,27,3,56,43,13,89,64,25,114,88,26,"{'F': 16, 'P': 11}","{'C': 22, 'J': 16, 'Z': 16}","{'Q': 24, 'R': 16, 'S': 8, 'T': 8, 'H': 16, 'M': 8}","{'Y': 8, 'A': 8, 'B': 4, 'D': 4, 'E': 4, 'G': 8, 'I': 4, 'K': 8, 'L': 4, 'N': 4, 'O': 4, 'U': 8, 'V': 4, 'W': 4, 'X': 4}"
INV-ZZ-0000393,SCH-ZZ-0000001,1001,Boeing 787,08/21/2024,08/21/2024,MAA,BLR,270,291,169,-101,122,27,54,81,108,30,16,14,61,25,36,90,66,24,110,62,48,"{'F': 16, 'P': 11}","{'C': 22, 'J': 16, 'Z': 16}","{'Q': 24, 'R': 16, 'S': 8, 'T': 8, 'H': 16, 'M': 8}","{'Y': 8, 'A': 8, 'B': 4, 'D': 4, 'E': 4, 'G': 8, 'I': 4, 'K': 8, 'L': 4, 'N': 4, 'O': 4, 'U': 8, 'V': 4, 'W': 4, 'X': 4}"
INV-ZZ-0000457,SCH-ZZ-0000065,1001,Boeing 787,08/21/2024,08/21/2024,MAA,BLR,270,292,199,-71,93,27,54,81,108,30,17,13,58,52,6,86,77,9,118,53,65,"{'F': 16, 'P': 11}","{'C': 22, 'J': 16, 'Z': 16}","{'Q': 24, 'R': 16, 'S': 8, 'T': 8, 'H': 16, 'M': 8}","{'Y': 8, 'A': 8, 'B': 4, 'D': 4, 'E': 4, 'G': 8, 'I': 4, 'K': 8, 'L': 4, 'N': 4, 'O': 4, 'U': 8, 'V': 4, 'W': 4, 'X': 4}"
INV-ZZ-0000521,SCH-ZZ-0000129,1001,Boeing 787,08/21/2024,08/21/2024,MAA,BLR,270,303,239,-31,64,27,54,81,108,31,27,4,59,26,33,85,79,6,128,107,21,"{'F': 16, 'P': 11}","{'C': 22, 'J': 16, 'Z': 16}","{'Q': 24, 'R': 16, 'S': 8, 'T': 8, 'H': 16, 'M': 8}","{'Y': 8, 'A': 8, 'B': 4, 'D': 4, 'E': 4, 'G': 8, 'I': 4, 'K': 8, 'L': 4, 'N': 4, 'O': 4, 'U': 8, 'V': 4, 'W': 4, 'X': 4}"
INV-ZZ-0000394,SCH-ZZ-0000002,1002,Boeing 787,08/21/2024,08/21/2024,MAA,BOM,270,291,204,-66,87,27,54,81,108,28,22,6,57,33,24,85,72,13,121,77,44,"{'F': 16, 'P': 11}","{'C': 22, 'J': 16, 'Z': 16}","{'Q': 24, 'R': 16, 'S': 8, 'T': 8, 'H': 16, 'M': 8}","{'Y': 8, 'A': 8, 'B': 4, 'D': 4, 'E': 4, 'G': 8, 'I': 4, 'K': 8, 'L': 4, 'N': 4, 'O': 4, 'U': 8, 'V': 4, 'W': 4, 'X': 4}"
INV-ZZ-0000458,SCH-ZZ-0000066,1002,Boeing 787,08/21/2024,08/21/2024,MAA,BOM,270,300,186,-84,114,27,54,81,108,31,14,17,55,35,20,87,59,28,127,78,49,"{'F': 16, 'P': 11}","{'C': 22, 'J': 16, 'Z': 16}","{'Q': 24, 'R': 16, 'S': 8, 'T': 8, 'H': 16, 'M': 8}","{'Y': 8, 'A': 8, 'B': 4, 'D': 4, 'E': 4, 'G': 8, 'I': 4, 'K': 8, 'L': 4, 'N': 4, 'O': 4, 'U': 8, 'V': 4, 'W': 4, 'X': 4}"
INV-ZZ-0000522,SCH-ZZ-0000130,1002,Boeing 787,08/21/2024,08/21/2024,MAA,BOM,270,294,203,-67,91,27,54,81,108,30,14,16,59,48,11,89,67,22,116,74,42,"{'F': 16, 'P': 11}","{'C': 22, 'J': 16, 'Z': 16}","{'Q': 24, 'R': 16, 'S': 8, 'T': 8, 'H': 16, 'M': 8}","{'Y': 8, 'A': 8, 'B': 4, 'D': 4, 'E': 4, 'G': 8, 'I': 4, 'K': 8, 'L': 4, 'N': 4, 'O': 4, 'U': 8, 'V': 4, 'W': 4, 'X': 4}"
INV-ZZ-0000395,SCH-ZZ-0000003,1003,Boeing 787,08/21/2024,08/21/2024,MAA,DUB,270,306,211,-59,95,27,54,81,108,28,16,12,61,36,25,91,51,40,126,108,18,"{'F': 16, 'P': 11}","{'C': 22, 'J': 16, 'Z': 16}","{'Q': 24, 'R': 16, 'S': 8, 'T': 8, 'H': 16, 'M': 8}","{'Y': 8, 'A': 8, 'B': 4, 'D': 4, 'E': 4, 'G': 8, 'I': 4, 'K': 8, 'L': 4, 'N': 4, 'O': 4, 'U': 8, 'V': 4, 'W': 4, 'X': 4}"
INV-ZZ-0000459,SCH-ZZ-0000067,1003,Boeing 787,08/21/2024,08/21/2024,MAA,DUB,270,294,141,-129,153,27,54,81,108,32,15,17,56,20,36,86,59,27,120,47,73,"{'F': 16, 'P': 11}","{'C': 22, 'J': 16, 'Z': 16}","{'Q': 24, 'R': 16, 'S': 8, 'T': 8, 'H': 16, 'M': 8}","{'Y': 8, 'A': 8, 'B': 4, 'D': 4, 'E': 4, 'G': 8, 'I': 4, 'K': 8, 'L': 4, 'N': 4, 'O': 4, 'U': 8, 'V': 4, 'W': 4, 'X': 4}"
INV-ZZ-0000523,SCH-ZZ-0000131,1003,Boeing 787,08/21/2024,08/21/2024,MAA,DUB,270,285,155,-115,130,27,54,81,108,32,22,10,55,25,30,87,58,29,111,50,61,"{'F': 16, 'P': 11}","{'C': 22, 'J': 16, 'Z': 16}","{'Q': 24, 'R': 16, 'S': 8, 'T': 8, 'H': 16, 'M': 8}","{'Y': 8, 'A': 8, 'B': 4, 'D': 4, 'E': 4, 'G': 8, 'I': 4, 'K': 8, 'L': 4, 'N': 4, 'O': 4, 'U': 8, 'V': 4, 'W': 4, 'X': 4}"
INV-ZZ-0000396,SCH-ZZ-0000004,1004,Boeing 787,08/21/2024,08/21/2024,MAA,VNS,270,294,153,-117,141,27,54,81,108,32,12,20,55,21,34,89,79,10,118,41,77,"{'F': 16, 'P': 11}","{'C': 22, 'J': 16, 'Z': 16}","{'Q': 24, 'R': 16, 'S': 8, 'T': 8, 'H': 16, 'M': 8}","{'Y': 8, 'A': 8, 'B': 4, 'D': 4, 'E': 4, 'G': 8, 'I': 4, 'K': 8, 'L': 4, 'N': 4, 'O': 4, 'U': 8, 'V': 4, 'W': 4, 'X': 4}"
INV-ZZ-0000460,SCH-ZZ-0000068,1004,Boeing 787,08/21/2024,08/21/2024,MAA,VNS,270,301,216,-54,85,27,54,81,108,29,24,5,58,26,32,87,80,7,127,86,41,"{'F': 16, 'P': 11}","{'C': 22, 'J': 16, 'Z': 16}","{'Q': 24, 'R': 16, 'S': 8, 'T': 8, 'H': 16, 'M': 8}","{'Y': 8, 'A': 8, 'B': 4, 'D': 4, 'E': 4, 'G': 8, 'I': 4, 'K': 8, 'L': 4, 'N': 4, 'O': 4, 'U': 8, 'V': 4, 'W': 4, 'X': 4}"
INV-ZZ-0000524,SCH-ZZ-0000132,1004,Boeing 787,08/21/2024,08/21/2024,MAA,VNS,270,285,208,-62,77,27,54,81,108,28,16,12,56,26,30,86,77,9,115,89,26,"{'F': 16, 'P': 11}","{'C': 22, 'J': 16, 'Z': 16}","{'Q': 24, 'R': 16, 'S': 8, 'T': 8, 'H': 16, 'M': 8}","{'Y': 8, 'A': 8, 'B': 4, 'D': 4, 'E': 4, 'G': 8, 'I': 4, 'K': 8, 'L': 4, 'N': 4, 'O': 4, 'U': 8, 'V': 4, 'W': 4, 'X': 4}"
INV-ZZ-0000397,SCH-ZZ-0000005,1005,Boeing 787,08/21/2024,08/21/2024,MAA,JFK,270,291,211,-59,80,27,54,81,108,28,12,16,57,35,22,89,56,33,117,108,9,"{'F': 16, 'P': 11}","{'C': 22, 'J': 16, 'Z': 16}","{'Q': 24, 'R': 16, 'S': 8, 'T': 8, 'H': 16, 'M': 8}","{'Y': 8, 'A': 8, 'B': 4, 'D': 4, 'E': 4, 'G': 8, 'I': 4, 'K': 8, 'L': 4, 'N': 4, 'O': 4, 'U': 8, 'V': 4, 'W': 4, 'X': 4}"
INV-ZZ-0000461,SCH-ZZ-0000069,1005,Boeing 787,08/21/2024,08/21/2024,MAA,JFK,270,283,219,-51,64,27,54,81,108,28,18,10,60,28,32,83,76,7,112,97,15,"{'F': 16, 'P': 11}","{'C': 22, 'J': 16, 'Z': 16}","{'Q': 24, 'R': 16, 'S': 8, 'T': 8, 'H': 16, 'M': 8}","{'Y': 8, 'A': 8, 'B': 4, 'D': 4, 'E': 4, 'G': 8, 'I': 4, 'K': 8, 'L': 4, 'N': 4, 'O': 4, 'U': 8, 'V': 4, 'W': 4, 'X': 4}"
INV-ZZ-0000525,SCH-ZZ-0000133,1005,Boeing 787,08/21/2024,08/21/2024,MAA,JFK,270,300,219,-51,81,27,54,81,108,30,26,4,59,52,7,89,64,25,122,77,45,"{'F': 16, 'P': 11}","{'C': 22, 'J': 16, 'Z': 16}","{'Q': 24, 'R': 16, 'S': 8, 'T': 8, 'H': 16, 'M': 8}","{'Y': 8, 'A': 8, 'B': 4, 'D': 4, 'E': 4, 'G': 8, 'I': 4, 'K': 8, 'L': 4, 'N': 4, 'O': 4, 'U': 8, 'V': 4, 'W': 4, 'X': 4}"
INV-ZZ-0000398,SCH-ZZ-0000006,1006,Boeing 787,08/21/2024,08/21/2024,MAA,DEL,270,290,203,-67,87,27,54,81,108,28,26,2,55,42,13,91,56,35,116,79,37,"{'F': 16, 'P': 11}","{'C': 22, 'J': 16, 'Z': 16}","{'Q': 24, 'R': 16, 'S': 8, 'T': 8, 'H': 16, 'M': 8}","{'Y': 8, 'A': 8, 'B': 4, 'D': 4, 'E': 4, 'G': 8, 'I': 4, 'K': 8, 'L': 4, 'N': 4, 'O': 4, 'U': 8, 'V': 4, 'W': 4, 'X': 4}"
INV-ZZ-0000462,SCH-ZZ-0000070,1006,Boeing 787,08/21/2024,08/21/2024,MAA,DEL,270,277,235,-35,42,27,54,81,108,31,12,19,55,52,3,82,73,9,109,98,11,"{'F': 16, 'P': 11}","{'C': 22, 'J': 16, 'Z': 16}","{'Q': 24, 'R': 16, 'S': 8, 'T': 8, 'H': 16, 'M': 8}","{'Y': 8, 'A': 8, 'B': 4, 'D': 4, 'E': 4, 'G': 8, 'I': 4, 'K': 8, 'L': 4, 'N': 4, 'O': 4, 'U': 8, 'V': 4, 'W': 4, 'X': 4}"
INV-ZZ-0000526,SCH-ZZ-0000134,1006,Boeing 787,08/21/2024,08/21/2024,MAA,DEL,270,298,209,-61,89,27,54,81,108,31,16,15,58,27,31,86,70,16,123,96,27,"{'F': 16, 'P': 11}","{'C': 22, 'J': 16, 'Z': 16}","{'Q': 24, 'R': 16, 'S': 8, 'T': 8, 'H': 16, 'M': 8}","{'Y': 8, 'A': 8, 'B': 4, 'D': 4, 'E': 4, 'G': 8, 'I': 4, 'K': 8, 'L': 4, 'N': 4, 'O': 4, 'U': 8, 'V': 4, 'W': 4, 'X': 4}"
INV-ZZ-0000399,SCH-ZZ-0000007,1007,Boeing 787,08/21/2024,08/21/2024,MAA,LAX,270,288,177,-93,111,27,54,81,108,29,12,17,60,50,10,87,57,30,112,58,54,"{'F': 16, 'P': 11}","{'C': 22, 'J': 16, 'Z': 16}","{'Q': 24, 'R': 16, 'S': 8, 'T': 8, 'H': 16, 'M': 8}","{'Y': 8, 'A': 8, 'B': 4, 'D': 4, 'E': 4, 'G': 8, 'I': 4, 'K': 8, 'L': 4, 'N': 4, 'O': 4, 'U': 8, 'V': 4, 'W': 4, 'X': 4}"
INV-ZZ-0000463,SCH-ZZ-0000071,1007,Boeing 787,08/21/2024,08/21/2024,MAA,LAX,270,300,160,-110,140,27,54,81,108,30,10,20,58,43,15,87,54,33,125,53,72,"{'F': 16, 'P': 11}","{'C': 22, 'J': 16, 'Z': 16}","{'Q': 24, 'R': 16, 'S': 8, 'T': 8, 'H': 16, 'M': 8}","{'Y': 8, 'A': 8, 'B': 4, 'D': 4, 'E': 4, 'G': 8, 'I': 4, 'K': 8, 'L': 4, 'N': 4, 'O': 4, 'U': 8, 'V': 4, 'W': 4, 'X': 4}"
INV-ZZ-0000527,SCH-ZZ-0000135,1007,Boeing 787,08/21/2024,08/21/2024,MAA,LAX,270,285,181,-89,104,27,54,81,108,28,25,3,57,46,11,90,59,31,110,51,59,"{'F': 16, 'P': 11}","{'C': 22, 'J': 16, 'Z': 16}","{'Q': 24, 'R': 16, 'S': 8, 'T': 8, 'H': 16, 'M': 8}","{'Y': 8, 'A': 8, 'B': 4, 'D': 4, 'E': 4, 'G': 8, 'I': 4, 'K': 8, 'L': 4, 'N': 4, 'O': 4, 'U': 8, 'V': 4, 'W': 4, 'X': 4}"
INV-ZZ-0000400,SCH-ZZ-0000008,1008,Boeing 787,08/21/2024,08/21/2024,BLR,MAA,270,303,208,-62,95,27,54,81,108,31,13,18,60,35,25,89,67,22,123,93,30,"{'F': 16, 'P': 11}","{'C': 22, 'J': 16, 'Z': 16}","{'Q': 24, 'R': 16, 'S': 8, 'T': 8, 'H': 16, 'M': 8}","{'Y': 8, 'A': 8, 'B': 4, 'D': 4, 'E': 4, 'G': 8, 'I': 4, 'K': 8, 'L': 4, 'N': 4, 'O': 4, 'U': 8, 'V': 4, 'W': 4, 'X': 4}"
INV-ZZ-0000464,SCH-ZZ-0000072,1008,Boeing 787,08/21/2024,08/21/2024,BLR,MAA,270,302,141,-129,161,27,54,81,108,29,15,14,59,30,29,90,41,49,124,55,69,"{'F': 16, 'P': 11}","{'C': 22, 'J': 16, 'Z': 16}","{'Q': 24, 'R': 16, 'S': 8, 'T': 8, 'H': 16, 'M': 8}","{'Y': 8, 'A': 8, 'B': 4, 'D': 4, 'E': 4, 'G': 8, 'I': 4, 'K': 8, 'L': 4, 'N': 4, 'O': 4, 'U': 8, 'V': 4, 'W': 4, 'X': 4}"
INV-ZZ-0000528,SCH-ZZ-0000136,1008,Boeing 787,08/21/2024,08/21/2024,BLR,MAA,270,298,204,-66,94,27,54,81,108,29,12,17,60,47,13,83,40,43,126,105,21,"{'F': 16, 'P': 11}","{'C': 22, 'J': 16, 'Z': 16}","{'Q': 24, 'R': 16, 'S': 8, 'T': 8, 'H': 16, 'M': 8}","{'Y': 8, 'A': 8, 'B': 4, 'D': 4, 'E': 4, 'G': 8, 'I': 4, 'K': 8, 'L': 4, 'N': 4, 'O': 4, 'U': 8, 'V': 4, 'W': 4, 'X': 4}"
INV-ZZ-0000402,SCH-ZZ-0000010,1010,Boeing 787,08/21/2024,08/21/2024,BLR,BOM,270,291,228,-42,63,27,54,81,108,30,21,9,56,52,4,85,64,21,120,91,29,"{'F': 16, 'P': 11}","{'C': 22, 'J': 16, 'Z': 16}","{'Q': 24, 'R': 16, 'S': 8, 'T': 8, 'H': 16, 'M': 8}","{'Y': 8, 'A': 8, 'B': 4, 'D': 4, 'E': 4, 'G': 8, 'I': 4, 'K': 8, 'L': 4, 'N': 4, 'O': 4, 'U': 8, 'V': 4, 'W': 4, 'X': 4}"
INV-ZZ-0000466,SCH-ZZ-0000074,1010,Boeing 787,08/21/2024,08/21/2024,BLR,BOM,270,284,217,-53,67,27,54,81,108,29,22,7,58,54,4,87,42,45,110,99,11,"{'F': 16, 'P': 11}","{'C': 22, 'J': 16, 'Z': 16}","{'Q': 24, 'R': 16, 'S': 8, 'T': 8, 'H': 16, 'M': 8}","{'Y': 8, 'A': 8, 'B': 4, 'D': 4, 'E': 4, 'G': 8, 'I': 4, 'K': 8, 'L': 4, 'N': 4, 'O': 4, 'U': 8, 'V': 4, 'W': 4, 'X': 4}"
INV-ZZ-0000530,SCH-ZZ-0000138,1010,Boeing 787,08/21/2024,08/21/2024,BLR,BOM,270,285,171,-99,114,27,54,81,108,31,11,20,55,54,1,83,63,20,116,43,73,"{'F': 16, 'P': 11}","{'C': 22, 'J': 16, 'Z': 16}","{'Q': 24, 'R': 16, 'S': 8, 'T': 8, 'H': 16, 'M': 8}","{'Y': 8, 'A': 8, 'B': 4, 'D': 4, 'E': 4, 'G': 8, 'I': 4, 'K': 8, 'L': 4, 'N': 4, 'O': 4, 'U': 8, 'V': 4, 'W': 4, 'X': 4}"
INV-ZZ-0000403,SCH-ZZ-0000011,1011,Boeing 787,08/21/2024,08/21/2024,BLR,DUB,270,289,222,-48,67,27,54,81,108,31,20,11,58,35,23,83,61,22,117,106,11,"{'F': 16, 'P': 11}","{'C': 22, 'J': 16, 'Z': 16}","{'Q': 24, 'R': 16, 'S': 8, 'T': 8, 'H': 16, 'M': 8}","{'Y': 8, 'A': 8, 'B': 4, 'D': 4, 'E': 4, 'G': 8, 'I': 4, 'K': 8, 'L': 4, 'N': 4, 'O': 4, 'U': 8, 'V': 4, 'W': 4, 'X': 4}"
INV-ZZ-0000467,SCH-ZZ-0000075,1011,Boeing 787,08/21/2024,08/21/2024,BLR,DUB,270,296,171,-99,125,27,54,81,108,28,18,10,55,22,33,90,40,50,123,91,32,"{'F': 16, 'P': 11}","{'C': 22, 'J': 16, 'Z': 16}","{'Q': 24, 'R': 16, 'S': 8, 'T': 8, 'H': 16, 'M': 8}","{'Y': 8, 'A': 8, 'B': 4, 'D': 4, 'E': 4, 'G': 8, 'I': 4, 'K': 8, 'L': 4, 'N': 4, 'O': 4, 'U': 8, 'V': 4, 'W': 4, 'X': 4}"
INV-ZZ-0000531,SCH-ZZ-0000139,1011,Boeing 787,08/21/2024,08/21/2024,BLR,DUB,270,288,169,-101,119,27,54,81,108,28,13,15,60,37,23,89,65,24,111,54,57,"{'F': 16, 'P': 11}","{'C': 22, 'J': 16, 'Z': 16}","{'Q': 24, 'R': 16, 'S': 8, 'T': 8, 'H': 16, 'M': 8}","{'Y': 8, 'A': 8, 'B': 4, 'D': 4, 'E': 4, 'G': 8, 'I': 4, 'K': 8, 'L': 4, 'N': 4, 'O': 4, 'U': 8, 'V': 4, 'W': 4, 'X': 4}"
INV-ZZ-0000404,SCH-ZZ-0000012,1012,Boeing 787,08/21/2024,08/21/2024,BLR,VNS,270,279,180,-90,99,27,54,81,108,30,23,7,55,48,7,84,58,26,110,51,59,"{'F': 16, 'P': 11}","{'C': 22, 'J': 16, 'Z': 16}","{'Q': 24, 'R': 16, 'S': 8, 'T': 8, 'H': 16, 'M': 8}","{'Y': 8, 'A': 8, 'B': 4, 'D': 4, 'E': 4, 'G': 8, 'I': 4, 'K': 8, 'L': 4, 'N': 4, 'O': 4, 'U': 8, 'V': 4, 'W': 4, 'X': 4}"
INV-ZZ-0000468,SCH-ZZ-0000076,1012,Boeing 787,08/21/2024,08/21/2024,BLR,VNS,270,300,208,-62,92,27,54,81,108,30,11,19,61,53,8,87,50,37,122,94,28,"{'F': 16, 'P': 11}","{'C': 22, 'J': 16, 'Z': 16}","{'Q': 24, 'R': 16, 'S': 8, 'T': 8, 'H': 16, 'M': 8}","{'Y': 8, 'A': 8, 'B': 4, 'D': 4, 'E': 4, 'G': 8, 'I': 4, 'K': 8, 'L': 4, 'N': 4, 'O': 4, 'U': 8, 'V': 4, 'W': 4, 'X': 4}"
INV-ZZ-0000532,SCH-ZZ-0000140,1012,Boeing 787,08/21/2024,08/21/2024,BLR,VNS,270,299,191,-79,108,27,54,81,108,31,27,4,61,45,16,88,39,49,119,80,39,"{'F': 16, 'P': 11}","{'C': 22, 'J': 16, 'Z': 16}","{'Q': 24, 'R': 16, 'S': 8, 'T': 8, 'H': 16, 'M': 8}","{'Y': 8, 'A': 8, 'B': 4, 'D': 4, 'E': 4, 'G': 8, 'I': 4, 'K': 8, 'L': 4, 'N': 4, 'O': 4, 'U': 8, 'V': 4, 'W': 4, 'X': 4}"
INV-ZZ-0000405,SCH-ZZ-0000013,1013,Boeing 787,08/21/2024,08/21/2024,BLR,JFK,270,295,194,-76,101,27,54,81,108,32,12,20,55,22,33,88,65,23,120,95,25,"{'F': 16, 'P': 11}","{'C': 22, 'J': 16, 'Z': 16}","{'Q': 24, 'R': 16, 'S': 8, 'T': 8, 'H': 16, 'M': 8}","{'Y': 8, 'A': 8, 'B': 4, 'D': 4, 'E': 4, 'G': 8, 'I': 4, 'K': 8, 'L': 4, 'N': 4, 'O': 4, 'U': 8, 'V': 4, 'W': 4, 'X': 4}"
INV-ZZ-0000469,SCH-ZZ-0000077,1013,Boeing 787,08/21/2024,08/21/2024,BLR,JFK,270,303,141,-129,162,27,54,81,108,32,16,16,61,47,14,86,37,49,124,41,83,"{'F': 16, 'P': 11}","{'C': 22, 'J': 16, 'Z': 16}","{'Q': 24, 'R': 16, 'S': 8, 'T': 8, 'H': 16, 'M': 8}","{'Y': 8, 'A': 8, 'B': 4, 'D': 4, 'E': 4, 'G': 8, 'I': 4, 'K': 8, 'L': 4, 'N': 4, 'O': 4, 'U': 8, 'V': 4, 'W': 4, 'X': 4}"
INV-ZZ-0000533,SCH-ZZ-0000141,1013,Boeing 787,08/21/2024,08/21/2024,BLR,JFK,270,300,174,-96,126,27,54,81,108,30,25,5,57,24,33,88,48,40,125,77,48,"{'F': 16, 'P': 11}","{'C': 22, 'J': 16, 'Z': 16}","{'Q': 24, 'R': 16, 'S': 8, 'T': 8, 'H': 16, 'M': 8}","{'Y': 8, 'A': 8, 'B': 4, 'D': 4, 'E': 4, 'G': 8, 'I': 4, 'K': 8, 'L': 4, 'N': 4, 'O': 4, 'U': 8, 'V': 4, 'W': 4, 'X': 4}"
INV-ZZ-0000406,SCH-ZZ-0000014,1014,Boeing 787,08/21/2024,08/21/2024,BLR,DEL,270,298,215,-55,83,27,54,81,108,29,24,5,57,48,9,90,80,10,122,63,59,"{'F': 16, 'P': 11}","{'C': 22, 'J': 16, 'Z': 16}","{'Q': 24, 'R': 16, 'S': 8, 'T': 8, 'H': 16, 'M': 8}","{'Y': 8, 'A': 8, 'B': 4, 'D': 4, 'E': 4, 'G': 8, 'I': 4, 'K': 8, 'L': 4, 'N': 4, 'O': 4, 'U': 8, 'V': 4, 'W': 4, 'X': 4}"
INV-ZZ-0000470,SCH-ZZ-0000078,1014,Boeing 787,08/21/2024,08/21/2024,BLR,DEL,270,293,226,-44,67,27,54,81,108,31,11,20,61,41,20,88,77,11,113,97,16,"{'F': 16, 'P': 11}","{'C': 22, 'J': 16, 'Z': 16}","{'Q': 24, 'R': 16, 'S': 8, 'T': 8, 'H': 16, 'M': 8}","{'Y': 8, 'A': 8, 'B': 4, 'D': 4, 'E': 4, 'G': 8, 'I': 4, 'K': 8, 'L': 4, 'N': 4, 'O': 4, 'U': 8, 'V': 4, 'W': 4, 'X': 4}"
INV-ZZ-0000534,SCH-ZZ-0000142,1014,Boeing 787,08/21/2024,08/21/2024,BLR,DEL,270,289,227,-43,62,27,54,81,108,28,23,5,59,42,17,82,58,24,120,104,16,"{'F': 16, 'P': 11}","{'C': 22, 'J': 16, 'Z': 16}","{'Q': 24, 'R': 16, 'S': 8, 'T': 8, 'H': 16, 'M': 8}","{'Y': 8, 'A': 8, 'B': 4, 'D': 4, 'E': 4, 'G': 8, 'I': 4, 'K': 8, 'L': 4, 'N': 4, 'O': 4, 'U': 8, 'V': 4, 'W': 4, 'X': 4}"
INV-ZZ-0000407,SCH-ZZ-0000015,1015,Boeing 787,08/21/2024,08/21/2024,BLR,LAX,270,292,167,-103,125,27,54,81,108,31,13,18,59,40,19,87,47,40,115,67,48,"{'F': 16, 'P': 11}","{'C': 22, 'J': 16, 'Z': 16}","{'Q': 24, 'R': 16, 'S': 8, 'T': 8, 'H': 16, 'M': 8}","{'Y': 8, 'A': 8, 'B': 4, 'D': 4, 'E': 4, 'G': 8, 'I': 4, 'K': 8, 'L': 4, 'N': 4, 'O': 4, 'U': 8, 'V': 4, 'W': 4, 'X': 4}"
INV-ZZ-0000471,SCH-ZZ-0000079,1015,Boeing 787,08/21/2024,08/21/2024,BLR,LAX,270,297,206,-64,91,27,54,81,108,30,27,3,57,37,20,91,78,13,119,64,55,"{'F': 16, 'P': 11}","{'C': 22, 'J': 16, 'Z': 16}","{'Q': 24, 'R': 16, 'S': 8, 'T': 8, 'H': 16, 'M': 8}","{'Y': 8, 'A': 8, 'B': 4, 'D': 4, 'E': 4, 'G': 8, 'I': 4, 'K': 8, 'L': 4, 'N': 4, 'O': 4, 'U': 8, 'V': 4, 'W': 4, 'X': 4}"
INV-ZZ-0000535,SCH-ZZ-0000143,1015,Boeing 787,08/21/2024,08/21/2024,BLR,LAX,270,287,215,-55,72,27,54,81,108,32,27,5,58,37,21,82,81,1,115,70,45,"{'F': 16, 'P': 11}","{'C': 22, 'J': 16, 'Z': 16}","{'Q': 24, 'R': 16, 'S': 8, 'T': 8, 'H': 16, 'M': 8}","{'Y': 8, 'A': 8, 'B': 4, 'D': 4, 'E': 4, 'G': 8, 'I': 4, 'K': 8, 'L': 4, 'N': 4, 'O': 4, 'U': 8, 'V': 4, 'W': 4, 'X': 4}"
INV-ZZ-0000408,SCH-ZZ-0000016,1016,Boeing 787,08/21/2024,08/21/2024,BOM,MAA,270,285,206,-64,79,27,54,81,108,30,21,9,60,33,27,85,77,8,110,75,35,"{'F': 16, 'P': 11}","{'C': 22, 'J': 16, 'Z': 16}","{'Q': 24, 'R': 16, 'S': 8, 'T': 8, 'H': 16, 'M': 8}","{'Y': 8, 'A': 8, 'B': 4, 'D': 4, 'E': 4, 'G': 8, 'I': 4, 'K': 8, 'L': 4, 'N': 4, 'O': 4, 'U': 8, 'V': 4, 'W': 4, 'X': 4}"
INV-ZZ-0000472,SCH-ZZ-0000080,1016,Boeing 787,08/21/2024,08/21/2024,BOM,MAA,270,294,196,-74,98,27,54,81,108,31,11,20,61,33,28,87,47,40,115,105,10,"{'F': 16, 'P': 11}","{'C': 22, 'J': 16, 'Z': 16}","{'Q': 24, 'R': 16, 'S': 8, 'T': 8, 'H': 16, 'M': 8}","{'Y': 8, 'A': 8, 'B': 4, 'D': 4, 'E': 4, 'G': 8, 'I': 4, 'K': 8, 'L': 4, 'N': 4, 'O': 4, 'U': 8, 'V': 4, 'W': 4, 'X': 4}"
INV-ZZ-0000536,SCH-ZZ-0000144,1016,Boeing 787,08/21/2024,08/21/2024,BOM,MAA,270,301,160,-110,141,27,54,81,108,29,19,10,60,25,35,85,57,28,127,59,68,"{'F': 16, 'P': 11}","{'C': 22, 'J': 16, 'Z': 16}","{'Q': 24, 'R': 16, 'S': 8, 'T': 8, 'H': 16, 'M': 8}","{'Y': 8, 'A': 8, 'B': 4, 'D': 4, 'E': 4, 'G': 8, 'I': 4, 'K': 8, 'L': 4, 'N': 4, 'O': 4, 'U': 8, 'V': 4, 'W': 4, 'X': 4}"
INV-ZZ-0000409,SCH-ZZ-0000017,1017,Boeing 787,08/21/2024,08/21/2024,BOM,BLR,270,307,242,-28,65,27,54,81,108,32,27,5,60,47,13,89,66,23,126,102,24,"{'F': 16, 'P': 11}","{'C': 22, 'J': 16, 'Z': 16}","{'Q': 24, 'R': 16, 'S': 8, 'T': 8, 'H': 16, 'M': 8}","{'Y': 8, 'A': 8, 'B': 4, 'D': 4, 'E': 4, 'G': 8, 'I': 4, 'K': 8, 'L': 4, 'N': 4, 'O': 4, 'U': 8, 'V': 4, 'W': 4, 'X': 4}"
INV-ZZ-0000473,SCH-ZZ-0000081,1017,Boeing 787,08/21/2024,08/21/2024,BOM,BLR,270,284,216,-54,68,27,54,81,108,32,19,13,56,47,9,83,71,12,113,79,34,"{'F': 16, 'P': 11}","{'C': 22, 'J': 16, 'Z': 16}","{'Q': 24, 'R': 16, 'S': 8, 'T': 8, 'H': 16, 'M': 8}","{'Y': 8, 'A': 8, 'B': 4, 'D': 4, 'E': 4, 'G': 8, 'I': 4, 'K': 8, 'L': 4, 'N': 4, 'O': 4, 'U': 8, 'V': 4, 'W': 4, 'X': 4}"
INV-ZZ-0000537,SCH-ZZ-0000145,1017,Boeing 787,08/21/2024,08/21/2024,BOM,BLR,270,291,174,-96,117,27,54,81,108,28,23,5,57,49,8,90,44,46,116,58,58,"{'F': 16, 'P': 11}","{'C': 22, 'J': 16, 'Z': 16}","{'Q': 24, 'R': 16, 'S': 8, 'T': 8, 'H': 16, 'M': 8}","{'Y': 8, 'A': 8, 'B': 4, 'D': 4, 'E': 4, 'G': 8, 'I': 4, 'K': 8, 'L': 4, 'N': 4, 'O': 4, 'U': 8, 'V': 4, 'W': 4, 'X': 4}"
INV-ZZ-0000411,SCH-ZZ-0000019,1019,Boeing 787,08/21/2024,08/21/2024,BOM,DUB,270,280,200,-70,80,27,54,81,108,30,14,16,57,51,6,84,68,16,109,67,42,"{'F': 16, 'P': 11}","{'C': 22, 'J': 16, 'Z': 16}","{'Q': 24, 'R': 16, 'S': 8, 'T': 8, 'H': 16, 'M': 8}","{'Y': 8, 'A': 8, 'B': 4, 'D': 4, 'E': 4, 'G': 8, 'I': 4, 'K': 8, 'L': 4, 'N': 4, 'O': 4, 'U': 8, 'V': 4, 'W': 4, 'X': 4}"
INV-ZZ-0000475,SCH-ZZ-0000083,1019,Boeing 787,08/21/2024,08/21/2024,BOM,DUB,270,291,162,-108,129,27,54,81,108,32,16,16,59,53,6,84,40,44,116,53,63,"{'F': 16, 'P': 11}","{'C': 22, 'J': 16, 'Z': 16}","{'Q': 24, 'R': 16, 'S': 8, 'T': 8, 'H': 16, 'M': 8}","{'Y': 8, 'A': 8, 'B': 4, 'D': 4, 'E': 4, 'G': 8, 'I': 4, 'K': 8, 'L': 4, 'N': 4, 'O': 4, 'U': 8, 'V': 4, 'W': 4, 'X': 4}"
INV-ZZ-0000539,SCH-ZZ-0000147,1019,Boeing 787,08/21/2024,08/21/2024,BOM,DUB,270,298,161,-109,137,27,54,81,108,30,16,14,55,20,35,90,61,29,123,64,59,"{'F': 16, 'P': 11}","{'C': 22, 'J': 16, 'Z': 16}","{'Q': 24, 'R': 16, 'S': 8, 'T': 8, 'H': 16, 'M': 8}","{'Y': 8, 'A': 8, 'B': 4, 'D': 4, 'E': 4, 'G': 8, 'I': 4, 'K': 8, 'L': 4, 'N': 4, 'O': 4, 'U': 8, 'V': 4, 'W': 4, 'X': 4}"
INV-ZZ-0000412,SCH-ZZ-0000020,1020,Boeing 787,08/21/2024,08/21/2024,BOM,VNS,270,298,169,-101,129,27,54,81,108,29,26,3,57,27,30,91,75,16,121,41,80,"{'F': 16, 'P': 11}","{'C': 22, 'J': 16, 'Z': 16}","{'Q': 24, 'R': 16, 'S': 8, 'T': 8, 'H': 16, 'M': 8}","{'Y': 8, 'A': 8, 'B': 4, 'D': 4, 'E': 4, 'G': 8, 'I': 4, 'K': 8, 'L': 4, 'N': 4, 'O': 4, 'U': 8, 'V': 4, 'W': 4, 'X': 4}"
INV-ZZ-0000476,SCH-ZZ-0000084,1020,Boeing 787,08/21/2024,08/21/2024,BOM,VNS,270,298,172,-98,126,27,54,81,108,29,20,9,59,20,39,83,80,3,127,52,75,"{'F': 16, 'P': 11}","{'C': 22, 'J': 16, 'Z': 16}","{'Q': 24, 'R': 16, 'S': 8, 'T': 8, 'H': 16, 'M': 8}","{'Y': 8, 'A': 8, 'B': 4, 'D': 4, 'E': 4, 'G': 8, 'I': 4, 'K': 8, 'L': 4, 'N': 4, 'O': 4, 'U': 8, 'V': 4, 'W': 4, 'X': 4}"
INV-ZZ-0000540,SCH-ZZ-0000148,1020,Boeing 787,08/21/2024,08/21/2024,BOM,VNS,270,304,186,-84,118,27,54,81,108,32,10,22,56,32,24,91,53,38,125,91,34,"{'F': 16, 'P': 11}","{'C': 22, 'J': 16, 'Z': 16}","{'Q': 24, 'R': 16, 'S': 8, 'T': 8, 'H': 16, 'M': 8}","{'Y': 8, 'A': 8, 'B': 4, 'D': 4, 'E': 4, 'G': 8, 'I': 4, 'K': 8, 'L': 4, 'N': 4, 'O': 4, 'U': 8, 'V': 4, 'W': 4, 'X': 4}"
INV-ZZ-0000413,SCH-ZZ-0000021,1021,Boeing 787,08/21/2024,08/21/2024,BOM,JFK,270,285,155,-115,130,27,54,81,108,31,26,5,55,49,6,83,37,46,116,43,73,"{'F': 16, 'P': 11}","{'C': 22, 'J': 16, 'Z': 16}","{'Q': 24, 'R': 16, 'S': 8, 'T': 8, 'H': 16, 'M': 8}","{'Y': 8, 'A': 8, 'B': 4, 'D': 4, 'E': 4, 'G': 8, 'I': 4, 'K': 8, 'L': 4, 'N': 4, 'O': 4, 'U': 8, 'V': 4, 'W': 4, 'X': 4}"
INV-ZZ-0000477,SCH-ZZ-0000085,1021,Boeing 787,08/21/2024,08/21/2024,BOM,JFK,270,295,180,-90,115,27,54,81,108,32,25,7,58,44,14,83,58,25,122,53,69,"{'F': 16, 'P': 11}","{'C': 22, 'J': 16, 'Z': 16}","{'Q': 24, 'R': 16, 'S': 8, 'T': 8, 'H': 16, 'M': 8}","{'Y': 8, 'A': 8, 'B': 4, 'D': 4, 'E': 4, 'G': 8, 'I': 4, 'K': 8, 'L': 4, 'N': 4, 'O': 4, 'U': 8, 'V': 4, 'W': 4, 'X': 4}"
INV-ZZ-0000541,SCH-ZZ-0000149,1021,Boeing 787,08/21/2024,08/21/2024,BOM,JFK,270,286,175,-95,111,27,54,81,108,29,19,10,59,54,5,89,55,34,109,47,62,"{'F': 16, 'P': 11}","{'C': 22, 'J': 16, 'Z': 16}","{'Q': 24, 'R': 16, 'S': 8, 'T': 8, 'H': 16, 'M': 8}","{'Y': 8, 'A': 8, 'B': 4, 'D': 4, 'E': 4, 'G': 8, 'I': 4, 'K': 8, 'L': 4, 'N': 4, 'O': 4, 'U': 8, 'V': 4, 'W': 4, 'X': 4}"
INV-ZZ-0000414,SCH-ZZ-0000022,1022,Boeing 787,08/21/2024,08/21/2024,BOM,DEL,270,299,209,-61,90,27,54,81,108,29,24,5,58,36,22,86,61,25,126,88,38,"{'F': 16, 'P': 11}","{'C': 22, 'J': 16, 'Z': 16}","{'Q': 24, 'R': 16, 'S': 8, 'T': 8, 'H': 16, 'M': 8}","{'Y': 8, 'A': 8, 'B': 4, 'D': 4, 'E': 4, 'G': 8, 'I': 4, 'K': 8, 'L': 4, 'N': 4, 'O': 4, 'U': 8, 'V': 4, 'W': 4, 'X': 4}"
INV-ZZ-0000478,SCH-ZZ-0000086,1022,Boeing 787,08/21/2024,08/21/2024,BOM,DEL,270,300,208,-62,92,27,54,81,108,28,18,10,61,49,12,91,37,54,120,104,16,"{'F': 16, 'P': 11}","{'C': 22, 'J': 16, 'Z': 16}","{'Q': 24, 'R': 16, 'S': 8, 'T': 8, 'H': 16, 'M': 8}","{'Y': 8, 'A': 8, 'B': 4, 'D': 4, 'E': 4, 'G': 8, 'I': 4, 'K': 8, 'L': 4, 'N': 4, 'O': 4, 'U': 8, 'V': 4, 'W': 4, 'X': 4}"
INV-ZZ-0000542,SCH-ZZ-0000150,1022,Boeing 787,08/21/2024,08/21/2024,BOM,DEL,270,296,193,-77,103,27,54,81,108,29,24,5,59,46,13,89,72,17,119,51,68,"{'F': 16, 'P': 11}","{'C': 22, 'J': 16, 'Z': 16}","{'Q': 24, 'R': 16, 'S': 8, 'T': 8, 'H': 16, 'M': 8}","{'Y': 8, 'A': 8, 'B': 4, 'D': 4, 'E': 4, 'G': 8, 'I': 4, 'K': 8, 'L': 4, 'N': 4, 'O': 4, 'U': 8, 'V': 4, 'W': 4, 'X': 4}"
INV-ZZ-0000415,SCH-ZZ-0000023,1023,Boeing 787,08/21/2024,08/21/2024,BOM,LAX,270,286,251,-19,35,27,54,81,108,29,18,11,59,52,7,82,81,1,116,100,16,"{'F': 16, 'P': 11}","{'C': 22, 'J': 16, 'Z': 16}","{'Q': 24, 'R': 16, 'S': 8, 'T': 8, 'H': 16, 'M': 8}","{'Y': 8, 'A': 8, 'B': 4, 'D': 4, 'E': 4, 'G': 8, 'I': 4, 'K': 8, 'L': 4, 'N': 4, 'O': 4, 'U': 8, 'V': 4, 'W': 4, 'X': 4}"
INV-ZZ-0000479,SCH-ZZ-0000087,1023,Boeing 787,08/21/2024,08/21/2024,BOM,LAX,270,307,165,-105,142,27,54,81,108,31,11,20,61,34,27,87,37,50,128,83,45,"{'F': 16, 'P': 11}","{'C': 22, 'J': 16, 'Z': 16}","{'Q': 24, 'R': 16, 'S': 8, 'T': 8, 'H': 16, 'M': 8}","{'Y': 8, 'A': 8, 'B': 4, 'D': 4, 'E': 4, 'G': 8, 'I': 4, 'K': 8, 'L': 4, 'N': 4, 'O': 4, 'U': 8, 'V': 4, 'W': 4, 'X': 4}"
INV-ZZ-0000543,SCH-ZZ-0000151,1023,Boeing 787,08/21/2024,08/21/2024,BOM,LAX,270,295,202,-68,93,27,54,81,108,28,14,14,59,50,9,86,72,14,122,66,56,"{'F': 16, 'P': 11}","{'C': 22, 'J': 16, 'Z': 16}","{'Q': 24, 'R': 16, 'S': 8, 'T': 8, 'H': 16, 'M': 8}","{'Y': 8, 'A': 8, 'B': 4, 'D': 4, 'E': 4, 'G': 8, 'I': 4, 'K': 8, 'L': 4, 'N': 4, 'O': 4, 'U': 8, 'V': 4, 'W': 4, 'X': 4}"
INV-ZZ-0000416,SCH-ZZ-0000024,1024,Boeing 787,08/21/2024,08/21/2024,DUB,MAA,270,287,176,-94,111,27,54,81,108,29,18,11,60,25,35,86,58,28,112,75,37,"{'F': 16, 'P': 11}","{'C': 22, 'J': 16, 'Z': 16}","{'Q': 24, 'R': 16, 'S': 8, 'T': 8, 'H': 16, 'M': 8}","{'Y': 8, 'A': 8, 'B': 4, 'D': 4, 'E': 4, 'G': 8, 'I': 4, 'K': 8, 'L': 4, 'N': 4, 'O': 4, 'U': 8, 'V': 4, 'W': 4, 'X': 4}"
INV-ZZ-0000480,SCH-ZZ-0000088,1024,Boeing 787,08/21/2024,08/21/2024,DUB,MAA,270,292,196,-74,96,27,54,81,108,31,16,15,56,40,16,86,51,35,119,89,30,"{'F': 16, 'P': 11}","{'C': 22, 'J': 16, 'Z': 16}","{'Q': 24, 'R': 16, 'S': 8, 'T': 8, 'H': 16, 'M': 8}","{'Y': 8, 'A': 8, 'B': 4, 'D': 4, 'E': 4, 'G': 8, 'I': 4, 'K': 8, 'L': 4, 'N': 4, 'O': 4, 'U': 8, 'V': 4, 'W': 4, 'X': 4}"
INV-ZZ-0000544,SCH-ZZ-0000152,1024,Boeing 787,08/21/2024,08/21/2024,DUB,MAA,270,295,227,-43,68,27,54,81,108,29,27,2,58,41,17,86,53,33,122,106,16,"{'F': 16, 'P': 11}","{'C': 22, 'J': 16, 'Z': 16}","{'Q': 24, 'R': 16, 'S': 8, 'T': 8, 'H': 16, 'M': 8}","{'Y': 8, 'A': 8, 'B': 4, 'D': 4, 'E': 4, 'G': 8, 'I': 4, 'K': 8, 'L': 4, 'N': 4, 'O': 4, 'U': 8, 'V': 4, 'W': 4, 'X': 4}"
INV-ZZ-0000417,SCH-ZZ-0000025,1025,Boeing 787,08/21/2024,08/21/2024,DUB,BLR,270,287,176,-94,111,27,54,81,108,28,26,2,57,41,16,82,40,42,120,69,51,"{'F': 16, 'P': 11}","{'C': 22, 'J': 16, 'Z': 16}","{'Q': 24, 'R': 16, 'S': 8, 'T': 8, 'H': 16, 'M': 8}","{'Y': 8, 'A': 8, 'B': 4, 'D': 4, 'E': 4, 'G': 8, 'I': 4, 'K': 8, 'L': 4, 'N': 4, 'O': 4, 'U': 8, 'V': 4, 'W': 4, 'X': 4}"
INV-ZZ-0000481,SCH-ZZ-0000089,1025,Boeing 787,08/21/2024,08/21/2024,DUB,BLR,270,287,176,-94,111,27,54,81,108,29,20,9,60,49,11,86,65,21,112,42,70,"{'F': 16, 'P': 11}","{'C': 22, 'J': 16, 'Z': 16}","{'Q': 24, 'R': 16, 'S': 8, 'T': 8, 'H': 16, 'M': 8}","{'Y': 8, 'A': 8, 'B': 4, 'D': 4, 'E': 4, 'G': 8, 'I': 4, 'K': 8, 'L': 4, 'N': 4, 'O': 4, 'U': 8, 'V': 4, 'W': 4, 'X': 4}"
INV-ZZ-0000545,SCH-ZZ-0000153,1025,Boeing 787,08/21/2024,08/21/2024,DUB,BLR,270,297,204,-66,93,27,54,81,108,29,15,14,56,48,8,88,55,33,124,86,38,"{'F': 16, 'P': 11}","{'C': 22, 'J': 16, 'Z': 16}","{'Q': 24, 'R': 16, 'S': 8, 'T': 8, 'H': 16, 'M': 8}","{'Y': 8, 'A': 8, 'B': 4, 'D': 4, 'E': 4, 'G': 8, 'I': 4, 'K': 8, 'L': 4, 'N': 4, 'O': 4, 'U': 8, 'V': 4, 'W': 4, 'X': 4}"
INV-ZZ-0000418,SCH-ZZ-0000026,1026,Boeing 787,08/21/2024,08/21/2024,DUB,BOM,270,298,190,-80,108,27,54,81,108,28,12,16,59,51,8,84,69,15,127,58,69,"{'F': 16, 'P': 11}","{'C': 22, 'J': 16, 'Z': 16}","{'Q': 24, 'R': 16, 'S': 8, 'T': 8, 'H': 16, 'M': 8}","{'Y': 8, 'A': 8, 'B': 4, 'D': 4, 'E': 4, 'G': 8, 'I': 4, 'K': 8, 'L': 4, 'N': 4, 'O': 4, 'U': 8, 'V': 4, 'W': 4, 'X': 4}"
INV-ZZ-0000482,SCH-ZZ-0000090,1026,Boeing 787,08/21/2024,08/21/2024,DUB,BOM,270,289,152,-118,137,27,54,81,108,32,25,7,57,22,35,84,41,43,116,64,52,"{'F': 16, 'P': 11}","{'C': 22, 'J': 16, 'Z': 16}","{'Q': 24, 'R': 16, 'S': 8, 'T': 8, 'H': 16, 'M': 8}","{'Y': 8, 'A': 8, 'B': 4, 'D': 4, 'E': 4, 'G': 8, 'I': 4, 'K': 8, 'L': 4, 'N': 4, 'O': 4, 'U': 8, 'V': 4, 'W': 4, 'X': 4}"
INV-ZZ-0000546,SCH-ZZ-0000154,1026,Boeing 787,08/21/2024,08/21/2024,DUB,BOM,270,302,190,-80,112,27,54,81,108,28,23,5,59,52,7,91,59,32,124,56,68,"{'F': 16, 'P': 11}","{'C': 22, 'J': 16, 'Z': 16}","{'Q': 24, 'R': 16, 'S': 8, 'T': 8, 'H': 16, 'M': 8}","{'Y': 8, 'A': 8, 'B': 4, 'D': 4, 'E': 4, 'G': 8, 'I': 4, 'K': 8, 'L': 4, 'N': 4, 'O': 4, 'U': 8, 'V': 4, 'W': 4, 'X': 4}"
INV-ZZ-0000420,SCH-ZZ-0000028,1028,Boeing 787,08/21/2024,08/21/2024,DUB,VNS,270,292,136,-134,156,27,54,81,108,32,10,22,58,28,30,86,39,47,116,59,57,"{'F': 16, 'P': 11}","{'C': 22, 'J': 16, 'Z': 16}","{'Q': 24, 'R': 16, 'S': 8, 'T': 8, 'H': 16, 'M': 8}","{'Y': 8, 'A': 8, 'B': 4, 'D': 4, 'E': 4, 'G': 8, 'I': 4, 'K': 8, 'L': 4, 'N': 4, 'O': 4, 'U': 8, 'V': 4, 'W': 4, 'X': 4}"
INV-ZZ-0000484,SCH-ZZ-0000092,1028,Boeing 787,08/21/2024,08/21/2024,DUB,VNS,270,297,218,-52,79,27,54,81,108,32,23,9,56,29,27,90,67,23,119,99,20,"{'F': 16, 'P': 11}","{'C': 22, 'J': 16, 'Z': 16}","{'Q': 24, 'R': 16, 'S': 8, 'T': 8, 'H': 16, 'M': 8}","{'Y': 8, 'A': 8, 'B': 4, 'D': 4, 'E': 4, 'G': 8, 'I': 4, 'K': 8, 'L': 4, 'N': 4, 'O': 4, 'U': 8, 'V': 4, 'W': 4, 'X': 4}"
INV-ZZ-0000548,SCH-ZZ-0000156,1028,Boeing 787,08/21/2024,08/21/2024,DUB,VNS,270,296,152,-118,144,27,54,81,108,29,17,12,57,43,14,90,37,53,120,55,65,"{'F': 16, 'P': 11}","{'C': 22, 'J': 16, 'Z': 16}","{'Q': 24, 'R': 16, 'S': 8, 'T': 8, 'H': 16, 'M': 8}","{'Y': 8, 'A': 8, 'B': 4, 'D': 4, 'E': 4, 'G': 8, 'I': 4, 'K': 8, 'L': 4, 'N': 4, 'O': 4, 'U': 8, 'V': 4, 'W': 4, 'X': 4}"
INV-ZZ-0000421,SCH-ZZ-0000029,1029,Boeing 787,08/21/2024,08/21/2024,DUB,JFK,270,289,228,-42,61,27,54,81,108,32,23,9,58,47,11,82,67,15,117,91,26,"{'F': 16, 'P': 11}","{'C': 22, 'J': 16, 'Z': 16}","{'Q': 24, 'R': 16, 'S': 8, 'T': 8, 'H': 16, 'M': 8}","{'Y': 8, 'A': 8, 'B': 4, 'D': 4, 'E': 4, 'G': 8, 'I': 4, 'K': 8, 'L': 4, 'N': 4, 'O': 4, 'U': 8, 'V': 4, 'W': 4, 'X': 4}"
INV-ZZ-0000485,SCH-ZZ-0000093,1029,Boeing 787,08/21/2024,08/21/2024,DUB,JFK,270,288,124,-146,164,27,54,81,108,32,16,16,58,28,30,83,37,46,115,43,72,"{'F': 16, 'P': 11}","{'C': 22, 'J': 16, 'Z': 16}","{'Q': 24, 'R': 16, 'S': 8, 'T': 8, 'H': 16, 'M': 8}","{'Y': 8, 'A': 8, 'B': 4, 'D': 4, 'E': 4, 'G': 8, 'I': 4, 'K': 8, 'L': 4, 'N': 4, 'O': 4, 'U': 8, 'V': 4, 'W': 4, 'X': 4}"
INV-ZZ-0000549,SCH-ZZ-0000157,1029,Boeing 787,08/21/2024,08/21/2024,DUB,JFK,270,290,178,-92,112,27,54,81,108,30,26,4,58,48,10,88,42,46,114,62,52,"{'F': 16, 'P': 11}","{'C': 22, 'J': 16, 'Z': 16}","{'Q': 24, 'R': 16, 'S': 8, 'T': 8, 'H': 16, 'M': 8}","{'Y': 8, 'A': 8, 'B': 4, 'D': 4, 'E': 4, 'G': 8, 'I': 4, 'K': 8, 'L': 4, 'N': 4, 'O': 4, 'U': 8, 'V': 4, 'W': 4, 'X': 4}"
INV-ZZ-0000422,SCH-ZZ-0000030,1030,Boeing 787,08/21/2024,08/21/2024,DUB,DEL,270,299,213,-57,86,27,54,81,108,30,12,18,61,53,8,88,78,10,120,70,50,"{'F': 16, 'P': 11}","{'C': 22, 'J': 16, 'Z': 16}","{'Q': 24, 'R': 16, 'S': 8, 'T': 8, 'H': 16, 'M': 8}","{'Y': 8, 'A': 8, 'B': 4, 'D': 4, 'E': 4, 'G': 8, 'I': 4, 'K': 8, 'L': 4, 'N': 4, 'O': 4, 'U': 8, 'V': 4, 'W': 4, 'X': 4}"
INV-ZZ-0000486,SCH-ZZ-0000094,1030,Boeing 787,08/21/2024,08/21/2024,DUB,DEL,270,289,192,-78,97,27,54,81,108,28,24,4,59,50,9,85,45,40,117,73,44,"{'F': 16, 'P': 11}","{'C': 22, 'J': 16, 'Z': 16}","{'Q': 24, 'R': 16, 'S': 8, 'T': 8, 'H': 16, 'M': 8}","{'Y': 8, 'A': 8, 'B': 4, 'D': 4, 'E': 4, 'G': 8, 'I': 4, 'K': 8, 'L': 4, 'N': 4, 'O': 4, 'U': 8, 'V': 4, 'W': 4, 'X': 4}"
INV-ZZ-0000550,SCH-ZZ-0000158,1030,Boeing 787,08/21/2024,08/21/2024,DUB,DEL,270,296,196,-74,100,27,54,81,108,29,21,8,57,52,5,87,74,13,123,49,74,"{'F': 16, 'P': 11}","{'C': 22, 'J': 16, 'Z': 16}","{'Q': 24, 'R': 16, 'S': 8, 'T': 8, 'H': 16, 'M': 8}","{'Y': 8, 'A': 8, 'B': 4, 'D': 4, 'E': 4, 'G': 8, 'I': 4, 'K': 8, 'L': 4, 'N': 4, 'O': 4, 'U': 8, 'V': 4, 'W': 4, 'X': 4}"
INV-ZZ-0000423,SCH-ZZ-0000031,1031,Boeing 787,08/21/2024,08/21/2024,DUB,LAX,270,303,216,-54,87,27,54,81,108,29,27,2,58,37,21,90,52,38,126,100,26,"{'F': 16, 'P': 11}","{'C': 22, 'J': 16, 'Z': 16}","{'Q': 24, 'R': 16, 'S': 8, 'T': 8, 'H': 16, 'M': 8}","{'Y': 8, 'A': 8, 'B': 4, 'D': 4, 'E': 4, 'G': 8, 'I': 4, 'K': 8, 'L': 4, 'N': 4, 'O': 4, 'U': 8, 'V': 4, 'W': 4, 'X': 4}"
INV-ZZ-0000487,SCH-ZZ-0000095,1031,Boeing 787,08/21/2024,08/21/2024,DUB,LAX,270,303,212,-58,91,27,54,81,108,29,14,15,59,51,8,90,73,17,125,74,51,"{'F': 16, 'P': 11}","{'C': 22, 'J': 16, 'Z': 16}","{'Q': 24, 'R': 16, 'S': 8, 'T': 8, 'H': 16, 'M': 8}","{'Y': 8, 'A': 8, 'B': 4, 'D': 4, 'E': 4, 'G': 8, 'I': 4, 'K': 8, 'L': 4, 'N': 4, 'O': 4, 'U': 8, 'V': 4, 'W': 4, 'X': 4}"
INV-ZZ-0000551,SCH-ZZ-0000159,1031,Boeing 787,08/21/2024,08/21/2024,DUB,LAX,270,295,153,-117,142,27,54,81,108,32,26,6,61,31,30,83,37,46,119,59,60,"{'F': 16, 'P': 11}","{'C': 22, 'J': 16, 'Z': 16}","{'Q': 24, 'R': 16, 'S': 8, 'T': 8, 'H': 16, 'M': 8}","{'Y': 8, 'A': 8, 'B': 4, 'D': 4, 'E': 4, 'G': 8, 'I': 4, 'K': 8, 'L': 4, 'N': 4, 'O': 4, 'U': 8, 'V': 4, 'W': 4, 'X': 4}"
INV-ZZ-0000424,SCH-ZZ-0000032,1032,Boeing 787,08/21/2024,08/21/2024,VNS,MAA,270,291,174,-96,117,27,54,81,108,30,21,9,59,44,15,90,53,37,112,56,56,"{'F': 16, 'P': 11}","{'C': 22, 'J': 16, 'Z': 16}","{'Q': 24, 'R': 16, 'S': 8, 'T': 8, 'H': 16, 'M': 8}","{'Y': 8, 'A': 8, 'B': 4, 'D': 4, 'E': 4, 'G': 8, 'I': 4, 'K': 8, 'L': 4, 'N': 4, 'O': 4, 'U': 8, 'V': 4, 'W': 4, 'X': 4}"
INV-ZZ-0000488,SCH-ZZ-0000096,1032,Boeing 787,08/21/2024,08/21/2024,VNS,MAA,270,298,164,-106,134,27,54,81,108,28,13,15,58,24,34,89,79,10,123,48,75,"{'F': 16, 'P': 11}","{'C': 22, 'J': 16, 'Z': 16}","{'Q': 24, 'R': 16, 'S': 8, 'T': 8, 'H': 16, 'M': 8}","{'Y': 8, 'A': 8, 'B': 4, 'D': 4, 'E': 4, 'G': 8, 'I': 4, 'K': 8, 'L': 4, 'N': 4, 'O': 4, 'U': 8, 'V': 4, 'W': 4, 'X': 4}"
INV-ZZ-0000552,SCH-ZZ-0000160,1032,Boeing 787,08/21/2024,08/21/2024,VNS,MAA,270,292,204,-66,88,27,54,81,108,29,25,4,57,26,31,89,62,27,117,91,26,"{'F': 16, 'P': 11}","{'C': 22, 'J': 16, 'Z': 16}","{'Q': 24, 'R': 16, 'S': 8, 'T': 8, 'H': 16, 'M': 8}","{'Y': 8, 'A': 8, 'B': 4, 'D': 4, 'E': 4, 'G': 8, 'I': 4, 'K': 8, 'L': 4, 'N': 4, 'O': 4, 'U': 8, 'V': 4, 'W': 4, 'X': 4}"
INV-ZZ-0000425,SCH-ZZ-0000033,1033,Boeing 787,08/21/2024,08/21/2024,VNS,BLR,270,289,214,-56,75,27,54,81,108,30,23,7,59,47,12,86,51,35,114,93,21,"{'F': 16, 'P': 11}","{'C': 22, 'J': 16, 'Z': 16}","{'Q': 24, 'R': 16, 'S': 8, 'T': 8, 'H': 16, 'M': 8}","{'Y': 8, 'A': 8, 'B': 4, 'D': 4, 'E': 4, 'G': 8, 'I': 4, 'K': 8, 'L': 4, 'N': 4, 'O': 4, 'U': 8, 'V': 4, 'W': 4, 'X': 4}"
INV-ZZ-0000489,SCH-ZZ-0000097,1033,Boeing 787,08/21/2024,08/21/2024,VNS,BLR,270,298,159,-111,139,27,54,81,108,30,10,20,57,39,18,88,59,29,123,51,72,"{'F': 16, 'P': 11}","{'C': 22, 'J': 16, 'Z': 16}","{'Q': 24, 'R': 16, 'S': 8, 'T': 8, 'H': 16, 'M': 8}","{'Y': 8, 'A': 8, 'B': 4, 'D': 4, 'E': 4, 'G': 8, 'I': 4, 'K': 8, 'L': 4, 'N': 4, 'O': 4, 'U': 8, 'V': 4, 'W': 4, 'X': 4}"
INV-ZZ-0000553,SCH-ZZ-0000161,1033,Boeing 787,08/21/2024,08/21/2024,VNS,BLR,270,294,164,-106,130,27,54,81,108,29,25,4,56,32,24,91,49,42,118,58,60,"{'F': 16, 'P': 11}","{'C': 22, 'J': 16, 'Z': 16}","{'Q': 24, 'R': 16, 'S': 8, 'T': 8, 'H': 16, 'M': 8}","{'Y': 8, 'A': 8, 'B': 4, 'D': 4, 'E': 4, 'G': 8, 'I': 4, 'K': 8, 'L': 4, 'N': 4, 'O': 4, 'U': 8, 'V': 4, 'W': 4, 'X': 4}"
INV-ZZ-0000426,SCH-ZZ-0000034,1034,Boeing 787,08/21/2024,08/21/2024,VNS,BOM,270,287,208,-62,79,27,54,81,108,28,15,13,61,48,13,83,59,24,115,86,29,"{'F': 16, 'P': 11}","{'C': 22, 'J': 16, 'Z': 16}","{'Q': 24, 'R': 16, 'S': 8, 'T': 8, 'H': 16, 'M': 8}","{'Y': 8, 'A': 8, 'B': 4, 'D': 4, 'E': 4, 'G': 8, 'I': 4, 'K': 8, 'L': 4, 'N': 4, 'O': 4, 'U': 8, 'V': 4, 'W': 4, 'X': 4}"
INV-ZZ-0000490,SCH-ZZ-0000098,1034,Boeing 787,08/21/2024,08/21/2024,VNS,BOM,270,296,190,-80,106,27,54,81,108,28,21,7,59,35,24,88,36,52,121,98,23,"{'F': 16, 'P': 11}","{'C': 22, 'J': 16, 'Z': 16}","{'Q': 24, 'R': 16, 'S': 8, 'T': 8, 'H': 16, 'M': 8}","{'Y': 8, 'A': 8, 'B': 4, 'D': 4, 'E': 4, 'G': 8, 'I': 4, 'K': 8, 'L': 4, 'N': 4, 'O': 4, 'U': 8, 'V': 4, 'W': 4, 'X': 4}"
INV-ZZ-0000554,SCH-ZZ-0000162,1034,Boeing 787,08/21/2024,08/21/2024,VNS,BOM,270,298,235,-35,63,27,54,81,108,32,22,10,57,41,16,88,75,13,121,97,24,"{'F': 16, 'P': 11}","{'C': 22, 'J': 16, 'Z': 16}","{'Q': 24, 'R': 16, 'S': 8, 'T': 8, 'H': 16, 'M': 8}","{'Y': 8, 'A': 8, 'B': 4, 'D': 4, 'E': 4, 'G': 8, 'I': 4, 'K': 8, 'L': 4, 'N': 4, 'O': 4, 'U': 8, 'V': 4, 'W': 4, 'X': 4}"
INV-ZZ-0000427,SCH-ZZ-0000035,1035,Boeing 787,08/21/2024,08/21/2024,VNS,DUB,270,300,232,-38,68,27,54,81,108,31,10,21,59,48,11,82,67,15,128,107,21,"{'F': 16, 'P': 11}","{'C': 22, 'J': 16, 'Z': 16}","{'Q': 24, 'R': 16, 'S': 8, 'T': 8, 'H': 16, 'M': 8}","{'Y': 8, 'A': 8, 'B': 4, 'D': 4, 'E': 4, 'G': 8, 'I': 4, 'K': 8, 'L': 4, 'N': 4, 'O': 4, 'U': 8, 'V': 4, 'W': 4, 'X': 4}"
INV-ZZ-0000491,SCH-ZZ-0000099,1035,Boeing 787,08/21/2024,08/21/2024,VNS,DUB,270,286,162,-108,124,27,54,81,108,31,22,9,56,30,26,82,70,12,117,40,77,"{'F': 16, 'P': 11}","{'C': 22, 'J': 16, 'Z': 16}","{'Q': 24, 'R': 16, 'S': 8, 'T': 8, 'H': 16, 'M': 8}","{'Y': 8, 'A': 8, 'B': 4, 'D': 4, 'E': 4, 'G': 8, 'I': 4, 'K': 8, 'L': 4, 'N': 4, 'O': 4, 'U': 8, 'V': 4, 'W': 4, 'X': 4}"
INV-ZZ-0000555,SCH-ZZ-0000163,1035,Boeing 787,08/21/2024,08/21/2024,VNS,DUB,270,303,172,-98,131,27,54,81,108,31,23,8,55,32,23,91,58,33,126,59,67,"{'F': 16, 'P': 11}","{'C': 22, 'J': 16, 'Z': 16}","{'Q': 24, 'R': 16, 'S': 8, 'T': 8, 'H': 16, 'M': 8}","{'Y': 8, 'A': 8, 'B': 4, 'D': 4, 'E': 4, 'G': 8, 'I': 4, 'K': 8, 'L': 4, 'N': 4, 'O': 4, 'U': 8, 'V': 4, 'W': 4, 'X': 4}"
INV-ZZ-0000429,SCH-ZZ-0000037,1037,Boeing 787,08/21/2024,08/21/2024,VNS,JFK,270,303,199,-71,104,27,54,81,108,31,21,10,58,50,8,88,48,40,126,80,46,"{'F': 16, 'P': 11}","{'C': 22, 'J': 16, 'Z': 16}","{'Q': 24, 'R': 16, 'S': 8, 'T': 8, 'H': 16, 'M': 8}","{'Y': 8, 'A': 8, 'B': 4, 'D': 4, 'E': 4, 'G': 8, 'I': 4, 'K': 8, 'L': 4, 'N': 4, 'O': 4, 'U': 8, 'V': 4, 'W': 4, 'X': 4}"
INV-ZZ-0000493,SCH-ZZ-0000101,1037,Boeing 787,08/21/2024,08/21/2024,VNS,JFK,270,301,161,-109,140,27,54,81,108,30,10,20,57,26,31,90,43,47,124,82,42,"{'F': 16, 'P': 11}","{'C': 22, 'J': 16, 'Z': 16}","{'Q': 24, 'R': 16, 'S': 8, 'T': 8, 'H': 16, 'M': 8}","{'Y': 8, 'A': 8, 'B': 4, 'D': 4, 'E': 4, 'G': 8, 'I': 4, 'K': 8, 'L': 4, 'N': 4, 'O': 4, 'U': 8, 'V': 4, 'W': 4, 'X': 4}"
INV-ZZ-0000557,SCH-ZZ-0000165,1037,Boeing 787,08/21/2024,08/21/2024,VNS,JFK,270,286,143,-127,143,27,54,81,108,30,24,6,61,28,33,86,41,45,109,50,59,"{'F': 16, 'P': 11}","{'C': 22, 'J': 16, 'Z': 16}","{'Q': 24, 'R': 16, 'S': 8, 'T': 8, 'H': 16, 'M': 8}","{'Y': 8, 'A': 8, 'B': 4, 'D': 4, 'E': 4, 'G': 8, 'I': 4, 'K': 8, 'L': 4, 'N': 4, 'O': 4, 'U': 8, 'V': 4, 'W': 4, 'X': 4}"
INV-ZZ-0000430,SCH-ZZ-0000038,1038,Boeing 787,08/21/2024,08/21/2024,VNS,DEL,270,291,156,-114,135,27,54,81,108,28,17,11,56,38,18,85,52,33,122,49,73,"{'F': 16, 'P': 11}","{'C': 22, 'J': 16, 'Z': 16}","{'Q': 24, 'R': 16, 'S': 8, 'T': 8, 'H': 16, 'M': 8}","{'Y': 8, 'A': 8, 'B': 4, 'D': 4, 'E': 4, 'G': 8, 'I': 4, 'K': 8, 'L': 4, 'N': 4, 'O': 4, 'U': 8, 'V': 4, 'W': 4, 'X': 4}"
INV-ZZ-0000494,SCH-ZZ-0000102,1038,Boeing 787,08/21/2024,08/21/2024,VNS,DEL,270,289,177,-93,112,27,54,81,108,30,18,12,61,42,19,87,62,25,111,55,56,"{'F': 16, 'P': 11}","{'C': 22, 'J': 16, 'Z': 16}","{'Q': 24, 'R': 16, 'S': 8, 'T': 8, 'H': 16, 'M': 8}","{'Y': 8, 'A': 8, 'B': 4, 'D': 4, 'E': 4, 'G': 8, 'I': 4, 'K': 8, 'L': 4, 'N': 4, 'O': 4, 'U': 8, 'V': 4, 'W': 4, 'X': 4}"
INV-ZZ-0000558,SCH-ZZ-0000166,1038,Boeing 787,08/21/2024,08/21/2024,VNS,DEL,270,310,181,-89,129,27,54,81,108,31,17,14,61,53,8,91,42,49,127,69,58,"{'F': 16, 'P': 11}","{'C': 22, 'J': 16, 'Z': 16}","{'Q': 24, 'R': 16, 'S': 8, 'T': 8, 'H': 16, 'M': 8}","{'Y': 8, 'A': 8, 'B': 4, 'D': 4, 'E': 4, 'G': 8, 'I': 4, 'K': 8, 'L': 4, 'N': 4, 'O': 4, 'U': 8, 'V': 4, 'W': 4, 'X': 4}"
INV-ZZ-0000431,SCH-ZZ-0000039,1039,Boeing 787,08/21/2024,08/21/2024,VNS,LAX,270,299,186,-84,113,27,54,81,108,30,12,18,61,21,40,84,73,11,124,80,44,"{'F': 16, 'P': 11}","{'C': 22, 'J': 16, 'Z': 16}","{'Q': 24, 'R': 16, 'S': 8, 'T': 8, 'H': 16, 'M': 8}","{'Y': 8, 'A': 8, 'B': 4, 'D': 4, 'E': 4, 'G': 8, 'I': 4, 'K': 8, 'L': 4, 'N': 4, 'O': 4, 'U': 8, 'V': 4, 'W': 4, 'X': 4}"
INV-ZZ-0000495,SCH-ZZ-0000103,1039,Boeing 787,08/21/2024,08/21/2024,VNS,LAX,270,287,192,-78,95,27,54,81,108,30,27,3,57,43,14,88,47,41,112,75,37,"{'F': 16, 'P': 11}","{'C': 22, 'J': 16, 'Z': 16}","{'Q': 24, 'R': 16, 'S': 8, 'T': 8, 'H': 16, 'M': 8}","{'Y': 8, 'A': 8, 'B': 4, 'D': 4, 'E': 4, 'G': 8, 'I': 4, 'K': 8, 'L': 4, 'N': 4, 'O': 4, 'U': 8, 'V': 4, 'W': 4, 'X': 4}"
INV-ZZ-0000559,SCH-ZZ-0000167,1039,Boeing 787,08/21/2024,08/21/2024,VNS,LAX,270,299,197,-73,102,27,54,81,108,29,22,7,60,49,11,83,49,34,127,77,50,"{'F': 16, 'P': 11}","{'C': 22, 'J': 16, 'Z': 16}","{'Q': 24, 'R': 16, 'S': 8, 'T': 8, 'H': 16, 'M': 8}","{'Y': 8, 'A': 8, 'B': 4, 'D': 4, 'E': 4, 'G': 8, 'I': 4, 'K': 8, 'L': 4, 'N': 4, 'O': 4, 'U': 8, 'V': 4, 'W': 4, 'X': 4}"
INV-ZZ-0000432,SCH-ZZ-0000040,1040,Boeing 787,08/21/2024,08/21/2024,JFK,MAA,270,292,204,-66,88,27,54,81,108,28,13,15,58,51,7,82,38,44,124,102,22,"{'F': 16, 'P': 11}","{'C': 22, 'J': 16, 'Z': 16}","{'Q': 24, 'R': 16, 'S': 8, 'T': 8, 'H': 16, 'M': 8}","{'Y': 8, 'A': 8, 'B': 4, 'D': 4, 'E': 4, 'G': 8, 'I': 4, 'K': 8, 'L': 4, 'N': 4, 'O': 4, 'U': 8, 'V': 4, 'W': 4, 'X': 4}"
INV-ZZ-0000496,SCH-ZZ-0000104,1040,Boeing 787,08/21/2024,08/21/2024,JFK,MAA,270,297,213,-57,84,27,54,81,108,29,11,18,59,40,19,91,80,11,118,82,36,"{'F': 16, 'P': 11}","{'C': 22, 'J': 16, 'Z': 16}","{'Q': 24, 'R': 16, 'S': 8, 'T': 8, 'H': 16, 'M': 8}","{'Y': 8, 'A': 8, 'B': 4, 'D': 4, 'E': 4, 'G': 8, 'I': 4, 'K': 8, 'L': 4, 'N': 4, 'O': 4, 'U': 8, 'V': 4, 'W': 4, 'X': 4}"
INV-ZZ-0000560,SCH-ZZ-0000168,1040,Boeing 787,08/21/2024,08/21/2024,JFK,MAA,270,293,195,-75,98,27,54,81,108,29,11,18,60,49,11,84,59,25,120,76,44,"{'F': 16, 'P': 11}","{'C': 22, 'J': 16, 'Z': 16}","{'Q': 24, 'R': 16, 'S': 8, 'T': 8, 'H': 16, 'M': 8}","{'Y': 8, 'A': 8, 'B': 4, 'D': 4, 'E': 4, 'G': 8, 'I': 4, 'K': 8, 'L': 4, 'N': 4, 'O': 4, 'U': 8, 'V': 4, 'W': 4, 'X': 4}"
INV-ZZ-0000433,SCH-ZZ-0000041,1041,Boeing 787,08/21/2024,08/21/2024,JFK,BLR,270,292,161,-109,131,27,54,81,108,31,23,8,56,48,8,82,49,33,123,41,82,"{'F': 16, 'P': 11}","{'C': 22, 'J': 16, 'Z': 16}","{'Q': 24, 'R': 16, 'S': 8, 'T': 8, 'H': 16, 'M': 8}","{'Y': 8, 'A': 8, 'B': 4, 'D': 4, 'E': 4, 'G': 8, 'I': 4, 'K': 8, 'L': 4, 'N': 4, 'O': 4, 'U': 8, 'V': 4, 'W': 4, 'X': 4}"
INV-ZZ-0000497,SCH-ZZ-0000105,1041,Boeing 787,08/21/2024,08/21/2024,JFK,BLR,270,296,179,-91,117,27,54,81,108,31,12,19,59,41,18,85,36,49,121,90,31,"{'F': 16, 'P': 11}","{'C': 22, 'J': 16, 'Z': 16}","{'Q': 24, 'R': 16, 'S': 8, 'T': 8, 'H': 16, 'M': 8}","{'Y': 8, 'A': 8, 'B': 4, 'D': 4, 'E': 4, 'G': 8, 'I': 4, 'K': 8, 'L': 4, 'N': 4, 'O': 4, 'U': 8, 'V': 4, 'W': 4, 'X': 4}"
INV-ZZ-0000561,SCH-ZZ-0000169,1041,Boeing 787,08/21/2024,08/21/2024,JFK,BLR,270,293,231,-39,62,27,54,81,108,28,27,1,60,50,10,89,76,13,116,78,38,"{'F': 16, 'P': 11}","{'C': 22, 'J': 16, 'Z': 16}","{'Q': 24, 'R': 16, 'S': 8, 'T': 8, 'H': 16, 'M': 8}","{'Y': 8, 'A': 8, 'B': 4, 'D': 4, 'E': 4, 'G': 8, 'I': 4, 'K': 8, 'L': 4, 'N': 4, 'O': 4, 'U': 8, 'V': 4, 'W': 4, 'X': 4}"
INV-ZZ-0000434,SCH-ZZ-0000042,1042,Boeing 787,08/21/2024,08/21/2024,JFK,BOM,270,295,182,-88,113,27,54,81,108,30,10,20,55,23,32,87,67,20,123,82,41,"{'F': 16, 'P': 11}","{'C': 22, 'J': 16, 'Z': 16}","{'Q': 24, 'R': 16, 'S': 8, 'T': 8, 'H': 16, 'M': 8}","{'Y': 8, 'A': 8, 'B': 4, 'D': 4, 'E': 4, 'G': 8, 'I': 4, 'K': 8, 'L': 4, 'N': 4, 'O': 4, 'U': 8, 'V': 4, 'W': 4, 'X': 4}"
INV-ZZ-0000498,SCH-ZZ-0000106,1042,Boeing 787,08/21/2024,08/21/2024,JFK,BOM,270,284,156,-114,128,27,54,81,108,30,10,20,56,40,16,89,49,40,109,57,52,"{'F': 16, 'P': 11}","{'C': 22, 'J': 16, 'Z': 16}","{'Q': 24, 'R': 16, 'S': 8, 'T': 8, 'H': 16, 'M': 8}","{'Y': 8, 'A': 8, 'B': 4, 'D': 4, 'E': 4, 'G': 8, 'I': 4, 'K': 8, 'L': 4, 'N': 4, 'O': 4, 'U': 8, 'V': 4, 'W': 4, 'X': 4}"
INV-ZZ-0000562,SCH-ZZ-0000170,1042,Boeing 787,08/21/2024,08/21/2024,JFK,BOM,270,308,184,-86,124,27,54,81,108,30,18,12,61,50,11,91,60,31,126,56,70,"{'F': 16, 'P': 11}","{'C': 22, 'J': 16, 'Z': 16}","{'Q': 24, 'R': 16, 'S': 8, 'T': 8, 'H': 16, 'M': 8}","{'Y': 8, 'A': 8, 'B': 4, 'D': 4, 'E': 4, 'G': 8, 'I': 4, 'K': 8, 'L': 4, 'N': 4, 'O': 4, 'U': 8, 'V': 4, 'W': 4, 'X': 4}"
INV-ZZ-0000435,SCH-ZZ-0000043,1043,Boeing 787,08/21/2024,08/21/2024,JFK,DUB,270,292,231,-39,61,27,54,81,108,29,25,4,56,53,3,86,73,13,121,80,41,"{'F': 16, 'P': 11}","{'C': 22, 'J': 16, 'Z': 16}","{'Q': 24, 'R': 16, 'S': 8, 'T': 8, 'H': 16, 'M': 8}","{'Y': 8, 'A': 8, 'B': 4, 'D': 4, 'E': 4, 'G': 8, 'I': 4, 'K': 8, 'L': 4, 'N': 4, 'O': 4, 'U': 8, 'V': 4, 'W': 4, 'X': 4}"
INV-ZZ-0000499,SCH-ZZ-0000107,1043,Boeing 787,08/21/2024,08/21/2024,JFK,DUB,270,292,236,-34,56,27,54,81,108,28,27,1,56,54,2,82,81,1,126,74,52,"{'F': 16, 'P': 11}","{'C': 22, 'J': 16, 'Z': 16}","{'Q': 24, 'R': 16, 'S': 8, 'T': 8, 'H': 16, 'M': 8}","{'Y': 8, 'A': 8, 'B': 4, 'D': 4, 'E': 4, 'G': 8, 'I': 4, 'K': 8, 'L': 4, 'N': 4, 'O': 4, 'U': 8, 'V': 4, 'W': 4, 'X': 4}"
INV-ZZ-0000563,SCH-ZZ-0000171,1043,Boeing 787,08/21/2024,08/21/2024,JFK,DUB,270,294,166,-104,128,27,54,81,108,28,13,15,58,41,17,87,40,47,121,72,49,"{'F': 16, 'P': 11}","{'C': 22, 'J': 16, 'Z': 16}","{'Q': 24, 'R': 16, 'S': 8, 'T': 8, 'H': 16, 'M': 8}","{'Y': 8, 'A': 8, 'B': 4, 'D': 4, 'E': 4, 'G': 8, 'I': 4, 'K': 8, 'L': 4, 'N': 4, 'O': 4, 'U': 8, 'V': 4, 'W': 4, 'X': 4}"
INV-ZZ-0000436,SCH-ZZ-0000044,1044,Boeing 787,08/21/2024,08/21/2024,JFK,VNS,270,293,233,-37,60,27,54,81,108,32,12,20,56,49,7,88,78,10,117,94,23,"{'F': 16, 'P': 11}","{'C': 22, 'J': 16, 'Z': 16}","{'Q': 24, 'R': 16, 'S': 8, 'T': 8, 'H': 16, 'M': 8}","{'Y': 8, 'A': 8, 'B': 4, 'D': 4, 'E': 4, 'G': 8, 'I': 4, 'K': 8, 'L': 4, 'N': 4, 'O': 4, 'U': 8, 'V': 4, 'W': 4, 'X': 4}"
INV-ZZ-0000500,SCH-ZZ-0000108,1044,Boeing 787,08/21/2024,08/21/2024,JFK,VNS,270,289,199,-71,90,27,54,81,108,30,27,3,60,38,22,84,36,48,115,98,17,"{'F': 16, 'P': 11}","{'C': 22, 'J': 16, 'Z': 16}","{'Q': 24, 'R': 16, 'S': 8, 'T': 8, 'H': 16, 'M': 8}","{'Y': 8, 'A': 8, 'B': 4, 'D': 4, 'E': 4, 'G': 8, 'I': 4, 'K': 8, 'L': 4, 'N': 4, 'O': 4, 'U': 8, 'V': 4, 'W': 4, 'X': 4}"
INV-ZZ-0000564,SCH-ZZ-0000172,1044,Boeing 787,08/21/2024,08/21/2024,JFK,VNS,270,301,159,-111,142,27,54,81,108,30,15,15,59,20,39,90,65,25,122,59,63,"{'F': 16, 'P': 11}","{'C': 22, 'J': 16, 'Z': 16}","{'Q': 24, 'R': 16, 'S': 8, 'T': 8, 'H': 16, 'M': 8}","{'Y': 8, 'A': 8, 'B': 4, 'D': 4, 'E': 4, 'G': 8, 'I': 4, 'K': 8, 'L': 4, 'N': 4, 'O': 4, 'U': 8, 'V': 4, 'W': 4, 'X': 4}"
INV-ZZ-0000438,SCH-ZZ-0000046,1046,Boeing 787,08/21/2024,08/21/2024,JFK,DEL,270,284,155,-115,129,27,54,81,108,28,16,12,60,26,34,83,73,10,113,40,73,"{'F': 16, 'P': 11}","{'C': 22, 'J': 16, 'Z': 16}","{'Q': 24, 'R': 16, 'S': 8, 'T': 8, 'H': 16, 'M': 8}","{'Y': 8, 'A': 8, 'B': 4, 'D': 4, 'E': 4, 'G': 8, 'I': 4, 'K': 8, 'L': 4, 'N': 4, 'O': 4, 'U': 8, 'V': 4, 'W': 4, 'X': 4}"
INV-ZZ-0000502,SCH-ZZ-0000110,1046,Boeing 787,08/21/2024,08/21/2024,JFK,DEL,270,280,230,-40,50,27,54,81,108,28,25,3,59,34,25,82,71,11,111,100,11,"{'F': 16, 'P': 11}","{'C': 22, 'J': 16, 'Z': 16}","{'Q': 24, 'R': 16, 'S': 8, 'T': 8, 'H': 16, 'M': 8}","{'Y': 8, 'A': 8, 'B': 4, 'D': 4, 'E': 4, 'G': 8, 'I': 4, 'K': 8, 'L': 4, 'N': 4, 'O': 4, 'U': 8, 'V': 4, 'W': 4, 'X': 4}"
INV-ZZ-0000566,SCH-ZZ-0000174,1046,Boeing 787,08/21/2024,08/21/2024,JFK,DEL,270,294,199,-71,95,27,54,81,108,29,20,9,55,42,13,89,47,42,121,90,31,"{'F': 16, 'P': 11}","{'C': 22, 'J': 16, 'Z': 16}","{'Q': 24, 'R': 16, 'S': 8, 'T': 8, 'H': 16, 'M': 8}","{'Y': 8, 'A': 8, 'B': 4, 'D': 4, 'E': 4, 'G': 8, 'I': 4, 'K': 8, 'L': 4, 'N': 4, 'O': 4, 'U': 8, 'V': 4, 'W': 4, 'X': 4}"
INV-ZZ-0000439,SCH-ZZ-0000047,1047,Boeing 787,08/21/2024,08/21/2024,JFK,LAX,270,294,221,-49,73,27,54,81,108,28,16,12,59,29,30,91,70,21,116,106,10,"{'F': 16, 'P': 11}","{'C': 22, 'J': 16, 'Z': 16}","{'Q': 24, 'R': 16, 'S': 8, 'T': 8, 'H': 16, 'M': 8}","{'Y': 8, 'A': 8, 'B': 4, 'D': 4, 'E': 4, 'G': 8, 'I': 4, 'K': 8, 'L': 4, 'N': 4, 'O': 4, 'U': 8, 'V': 4, 'W': 4, 'X': 4}"
INV-ZZ-0000503,SCH-ZZ-0000111,1047,Boeing 787,08/21/2024,08/21/2024,JFK,LAX,270,295,191,-79,104,27,54,81,108,30,25,5,60,20,40,87,78,9,118,68,50,"{'F': 16, 'P': 11}","{'C': 22, 'J': 16, 'Z': 16}","{'Q': 24, 'R': 16, 'S': 8, 'T': 8, 'H': 16, 'M': 8}","{'Y': 8, 'A': 8, 'B': 4, 'D': 4, 'E': 4, 'G': 8, 'I': 4, 'K': 8, 'L': 4, 'N': 4, 'O': 4, 'U': 8, 'V': 4, 'W': 4, 'X': 4}"
INV-ZZ-0000567,SCH-ZZ-0000175,1047,Boeing 787,08/21/2024,08/21/2024,JFK,LAX,270,300,186,-84,114,27,54,81,108,32,21,11,57,34,23,89,75,14,122,56,66,"{'F': 16, 'P': 11}","{'C': 22, 'J': 16, 'Z': 16}","{'Q': 24, 'R': 16, 'S': 8, 'T': 8, 'H': 16, 'M': 8}","{'Y': 8, 'A': 8, 'B': 4, 'D': 4, 'E': 4, 'G': 8, 'I': 4, 'K': 8, 'L': 4, 'N': 4, 'O': 4, 'U': 8, 'V': 4, 'W': 4, 'X': 4}"
INV-ZZ-0000440,SCH-ZZ-0000048,1048,Boeing 787,08/21/2024,08/21/2024,DEL,MAA,270,290,199,-71,91,27,54,81,108,32,16,16,55,32,23,83,76,7,120,75,45,"{'F': 16, 'P': 11}","{'C': 22, 'J': 16, 'Z': 16}","{'Q': 24, 'R': 16, 'S': 8, 'T': 8, 'H': 16, 'M': 8}","{'Y': 8, 'A': 8, 'B': 4, 'D': 4, 'E': 4, 'G': 8, 'I': 4, 'K': 8, 'L': 4, 'N': 4, 'O': 4, 'U': 8, 'V': 4, 'W': 4, 'X': 4}"
INV-ZZ-0000504,SCH-ZZ-0000112,1048,Boeing 787,08/21/2024,08/21/2024,DEL,MAA,270,302,172,-98,130,27,54,81,108,29,19,10,56,22,34,90,48,42,127,83,44,"{'F': 16, 'P': 11}","{'C': 22, 'J': 16, 'Z': 16}","{'Q': 24, 'R': 16, 'S': 8, 'T': 8, 'H': 16, 'M': 8}","{'Y': 8, 'A': 8, 'B': 4, 'D': 4, 'E': 4, 'G': 8, 'I': 4, 'K': 8, 'L': 4, 'N': 4, 'O': 4, 'U': 8, 'V': 4, 'W': 4, 'X': 4}"
INV-ZZ-0000568,SCH-ZZ-0000176,1048,Boeing 787,08/21/2024,08/21/2024,DEL,MAA,270,289,181,-89,108,27,54,81,108,30,16,14,58,37,21,86,81,5,115,47,68,"{'F': 16, 'P': 11}","{'C': 22, 'J': 16, 'Z': 16}","{'Q': 24, 'R': 16, 'S': 8, 'T': 8, 'H': 16, 'M': 8}","{'Y': 8, 'A': 8, 'B': 4, 'D': 4, 'E': 4, 'G': 8, 'I': 4, 'K': 8, 'L': 4, 'N': 4, 'O': 4, 'U': 8, 'V': 4, 'W': 4, 'X': 4}"
INV-ZZ-0000441,SCH-ZZ-0000049,1049,Boeing 787,08/21/2024,08/21/2024,DEL,BLR,270,294,176,-94,118,27,54,81,108,32,14,18,61,48,13,88,67,21,113,47,66,"{'F': 16, 'P': 11}","{'C': 22, 'J': 16, 'Z': 16}","{'Q': 24, 'R': 16, 'S': 8, 'T': 8, 'H': 16, 'M': 8}","{'Y': 8, 'A': 8, 'B': 4, 'D': 4, 'E': 4, 'G': 8, 'I': 4, 'K': 8, 'L': 4, 'N': 4, 'O': 4, 'U': 8, 'V': 4, 'W': 4, 'X': 4}"
INV-ZZ-0000505,SCH-ZZ-0000113,1049,Boeing 787,08/21/2024,08/21/2024,DEL,BLR,270,292,236,-34,56,27,54,81,108,30,26,4,56,49,7,87,64,23,119,97,22,"{'F': 16, 'P': 11}","{'C': 22, 'J': 16, 'Z': 16}","{'Q': 24, 'R': 16, 'S': 8, 'T': 8, 'H': 16, 'M': 8}","{'Y': 8, 'A': 8, 'B': 4, 'D': 4, 'E': 4, 'G': 8, 'I': 4, 'K': 8, 'L': 4, 'N': 4, 'O': 4, 'U': 8, 'V': 4, 'W': 4, 'X': 4}"
INV-ZZ-0000569,SCH-ZZ-0000177,1049,Boeing 787,08/21/2024,08/21/2024,DEL,BLR,270,294,196,-74,98,27,54,81,108,30,16,14,56,33,23,89,51,38,119,96,23,"{'F': 16, 'P': 11}","{'C': 22, 'J': 16, 'Z': 16}","{'Q': 24, 'R': 16, 'S': 8, 'T': 8, 'H': 16, 'M': 8}","{'Y': 8, 'A': 8, 'B': 4, 'D': 4, 'E': 4, 'G': 8, 'I': 4, 'K': 8, 'L': 4, 'N': 4, 'O': 4, 'U': 8, 'V': 4, 'W': 4, 'X': 4}"
INV-ZZ-0000442,SCH-ZZ-0000050,1050,Boeing 787,08/21/2024,08/21/2024,DEL,BOM,270,275,145,-125,130,27,54,81,108,28,17,11,56,27,29,82,52,30,109,49,60,"{'F': 16, 'P': 11}","{'C': 22, 'J': 16, 'Z': 16}","{'Q': 24, 'R': 16, 'S': 8, 'T': 8, 'H': 16, 'M': 8}","{'Y': 8, 'A': 8, 'B': 4, 'D': 4, 'E': 4, 'G': 8, 'I': 4, 'K': 8, 'L': 4, 'N': 4, 'O': 4, 'U': 8, 'V': 4, 'W': 4, 'X': 4}"
INV-ZZ-0000506,SCH-ZZ-0000114,1050,Boeing 787,08/21/2024,08/21/2024,DEL,BOM,270,291,194,-76,97,27,54,81,108,32,13,19,61,38,23,84,45,39,114,98,16,"{'F': 16, 'P': 11}","{'C': 22, 'J': 16, 'Z': 16}","{'Q': 24, 'R': 16, 'S': 8, 'T': 8, 'H': 16, 'M': 8}","{'Y': 8, 'A': 8, 'B': 4, 'D': 4, 'E': 4, 'G': 8, 'I': 4, 'K': 8, 'L': 4, 'N': 4, 'O': 4, 'U': 8, 'V': 4, 'W': 4, 'X': 4}"
INV-ZZ-0000570,SCH-ZZ-0000178,1050,Boeing 787,08/21/2024,08/21/2024,DEL,BOM,270,299,191,-79,108,27,54,81,108,30,26,4,60,47,13,83,57,26,126,61,65,"{'F': 16, 'P': 11}","{'C': 22, 'J': 16, 'Z': 16}","{'Q': 24, 'R': 16, 'S': 8, 'T': 8, 'H': 16, 'M': 8}","{'Y': 8, 'A': 8, 'B': 4, 'D': 4, 'E': 4, 'G': 8, 'I': 4, 'K': 8, 'L': 4, 'N': 4, 'O': 4, 'U': 8, 'V': 4, 'W': 4, 'X': 4}"
INV-ZZ-0000443,SCH-ZZ-0000051,1051,Boeing 787,08/21/2024,08/21/2024,DEL,DUB,270,293,233,-37,60,27,54,81,108,31,16,15,61,53,8,89,67,22,112,97,15,"{'F': 16, 'P': 11}","{'C': 22, 'J': 16, 'Z': 16}","{'Q': 24, 'R': 16, 'S': 8, 'T': 8, 'H': 16, 'M': 8}","{'Y': 8, 'A': 8, 'B': 4, 'D': 4, 'E': 4, 'G': 8, 'I': 4, 'K': 8, 'L': 4, 'N': 4, 'O': 4, 'U': 8, 'V': 4, 'W': 4, 'X': 4}"
INV-ZZ-0000507,SCH-ZZ-0000115,1051,Boeing 787,08/21/2024,08/21/2024,DEL,DUB,270,298,197,-73,101,27,54,81,108,32,26,6,60,51,9,84,37,47,122,83,39,"{'F': 16, 'P': 11}","{'C': 22, 'J': 16, 'Z': 16}","{'Q': 24, 'R': 16, 'S': 8, 'T': 8, 'H': 16, 'M': 8}","{'Y': 8, 'A': 8, 'B': 4, 'D': 4, 'E': 4, 'G': 8, 'I': 4, 'K': 8, 'L': 4, 'N': 4, 'O': 4, 'U': 8, 'V': 4, 'W': 4, 'X': 4}"
INV-ZZ-0000571,SCH-ZZ-0000179,1051,Boeing 787,08/21/2024,08/21/2024,DEL,DUB,270,304,203,-67,101,27,54,81,108,28,21,7,57,21,36,91,72,19,128,89,39,"{'F': 16, 'P': 11}","{'C': 22, 'J': 16, 'Z': 16}","{'Q': 24, 'R': 16, 'S': 8, 'T': 8, 'H': 16, 'M': 8}","{'Y': 8, 'A': 8, 'B': 4, 'D': 4, 'E': 4, 'G': 8, 'I': 4, 'K': 8, 'L': 4, 'N': 4, 'O': 4, 'U': 8, 'V': 4, 'W': 4, 'X': 4}"
INV-ZZ-0000444,SCH-ZZ-0000052,1052,Boeing 787,08/21/2024,08/21/2024,DEL,VNS,270,281,155,-115,126,27,54,81,108,29,21,8,55,20,35,87,39,48,110,75,35,"{'F': 16, 'P': 11}","{'C': 22, 'J': 16, 'Z': 16}","{'Q': 24, 'R': 16, 'S': 8, 'T': 8, 'H': 16, 'M': 8}","{'Y': 8, 'A': 8, 'B': 4, 'D': 4, 'E': 4, 'G': 8, 'I': 4, 'K': 8, 'L': 4, 'N': 4, 'O': 4, 'U': 8, 'V': 4, 'W': 4, 'X': 4}"
INV-ZZ-0000508,SCH-ZZ-0000116,1052,Boeing 787,08/21/2024,08/21/2024,DEL,VNS,270,302,186,-84,116,27,54,81,108,28,25,3,60,20,40,89,81,8,125,60,65,"{'F': 16, 'P': 11}","{'C': 22, 'J': 16, 'Z': 16}","{'Q': 24, 'R': 16, 'S': 8, 'T': 8, 'H': 16, 'M': 8}","{'Y': 8, 'A': 8, 'B': 4, 'D': 4, 'E': 4, 'G': 8, 'I': 4, 'K': 8, 'L': 4, 'N': 4, 'O': 4, 'U': 8, 'V': 4, 'W': 4, 'X': 4}"
INV-ZZ-0000572,SCH-ZZ-0000180,1052,Boeing 787,08/21/2024,08/21/2024,DEL,VNS,270,290,169,-101,121,27,54,81,108,28,10,18,60,46,14,89,52,37,113,61,52,"{'F': 16, 'P': 11}","{'C': 22, 'J': 16, 'Z': 16}","{'Q': 24, 'R': 16, 'S': 8, 'T': 8, 'H': 16, 'M': 8}","{'Y': 8, 'A': 8, 'B': 4, 'D': 4, 'E': 4, 'G': 8, 'I': 4, 'K': 8, 'L': 4, 'N': 4, 'O': 4, 'U': 8, 'V': 4, 'W': 4, 'X': 4}"
INV-ZZ-0000445,SCH-ZZ-0000053,1053,Boeing 787,08/21/2024,08/21/2024,DEL,JFK,270,290,189,-81,101,27,54,81,108,32,19,13,58,20,38,87,57,30,113,93,20,"{'F': 16, 'P': 11}","{'C': 22, 'J': 16, 'Z': 16}","{'Q': 24, 'R': 16, 'S': 8, 'T': 8, 'H': 16, 'M': 8}","{'Y': 8, 'A': 8, 'B': 4, 'D': 4, 'E': 4, 'G': 8, 'I': 4, 'K': 8, 'L': 4, 'N': 4, 'O': 4, 'U': 8, 'V': 4, 'W': 4, 'X': 4}"
INV-ZZ-0000509,SCH-ZZ-0000117,1053,Boeing 787,08/21/2024,08/21/2024,DEL,JFK,270,304,191,-79,113,27,54,81,108,31,10,21,56,34,22,90,68,22,127,79,48,"{'F': 16, 'P': 11}","{'C': 22, 'J': 16, 'Z': 16}","{'Q': 24, 'R': 16, 'S': 8, 'T': 8, 'H': 16, 'M': 8}","{'Y': 8, 'A': 8, 'B': 4, 'D': 4, 'E': 4, 'G': 8, 'I': 4, 'K': 8, 'L': 4, 'N': 4, 'O': 4, 'U': 8, 'V': 4, 'W': 4, 'X': 4}"
INV-ZZ-0000573,SCH-ZZ-0000181,1053,Boeing 787,08/21/2024,08/21/2024,DEL,JFK,270,291,231,-39,60,27,54,81,108,28,14,14,56,38,18,82,78,4,125,101,24,"{'F': 16, 'P': 11}","{'C': 22, 'J': 16, 'Z': 16}","{'Q': 24, 'R': 16, 'S': 8, 'T': 8, 'H': 16, 'M': 8}","{'Y': 8, 'A': 8, 'B': 4, 'D': 4, 'E': 4, 'G': 8, 'I': 4, 'K': 8, 'L': 4, 'N': 4, 'O': 4, 'U': 8, 'V': 4, 'W': 4, 'X': 4}"
INV-ZZ-0000447,SCH-ZZ-0000055,1055,Boeing 787,08/21/2024,08/21/2024,DEL,LAX,270,290,243,-27,47,27,54,81,108,31,18,13,60,40,20,87,78,9,112,107,5,"{'F': 16, 'P': 11}","{'C': 22, 'J': 16, 'Z': 16}","{'Q': 24, 'R': 16, 'S': 8, 'T': 8, 'H': 16, 'M': 8}","{'Y': 8, 'A': 8, 'B': 4, 'D': 4, 'E': 4, 'G': 8, 'I': 4, 'K': 8, 'L': 4, 'N': 4, 'O': 4, 'U': 8, 'V': 4, 'W': 4, 'X': 4}"
INV-ZZ-0000511,SCH-ZZ-0000119,1055,Boeing 787,08/21/2024,08/21/2024,DEL,LAX,270,304,236,-34,68,27,54,81,108,32,19,13,61,49,12,89,74,15,122,94,28,"{'F': 16, 'P': 11}","{'C': 22, 'J': 16, 'Z': 16}","{'Q': 24, 'R': 16, 'S': 8, 'T': 8, 'H': 16, 'M': 8}","{'Y': 8, 'A': 8, 'B': 4, 'D': 4, 'E': 4, 'G': 8, 'I': 4, 'K': 8, 'L': 4, 'N': 4, 'O': 4, 'U': 8, 'V': 4, 'W': 4, 'X': 4}"
INV-ZZ-0000575,SCH-ZZ-0000183,1055,Boeing 787,08/21/2024,08/21/2024,DEL,LAX,270,288,155,-115,133,27,54,81,108,30,23,7,59,22,37,90,46,44,109,64,45,"{'F': 16, 'P': 11}","{'C': 22, 'J': 16, 'Z': 16}","{'Q': 24, 'R': 16, 'S': 8, 'T': 8, 'H': 16, 'M': 8}","{'Y': 8, 'A': 8, 'B': 4, 'D': 4, 'E': 4, 'G': 8, 'I': 4, 'K': 8, 'L': 4, 'N': 4, 'O': 4, 'U': 8, 'V': 4, 'W': 4, 'X': 4}"
INV-ZZ-0000448,SCH-ZZ-0000056,1056,Boeing 787,08/21/2024,08/21/2024,LAX,MAA,270,283,185,-85,98,27,54,81,108,32,12,20,56,51,5,82,47,35,113,75,38,"{'F': 16, 'P': 11}","{'C': 22, 'J': 16, 'Z': 16}","{'Q': 24, 'R': 16, 'S': 8, 'T': 8, 'H': 16, 'M': 8}","{'Y': 8, 'A': 8, 'B': 4, 'D': 4, 'E': 4, 'G': 8, 'I': 4, 'K': 8, 'L': 4, 'N': 4, 'O': 4, 'U': 8, 'V': 4, 'W': 4, 'X': 4}"
INV-ZZ-0000512,SCH-ZZ-0000120,1056,Boeing 787,08/21/2024,08/21/2024,LAX,MAA,270,286,161,-109,125,27,54,81,108,32,24,8,55,31,24,89,49,40,110,57,53,"{'F': 16, 'P': 11}","{'C': 22, 'J': 16, 'Z': 16}","{'Q': 24, 'R': 16, 'S': 8, 'T': 8, 'H': 16, 'M': 8}","{'Y': 8, 'A': 8, 'B': 4, 'D': 4, 'E': 4, 'G': 8, 'I': 4, 'K': 8, 'L': 4, 'N': 4, 'O': 4, 'U': 8, 'V': 4, 'W': 4, 'X': 4}"
INV-ZZ-0000576,SCH-ZZ-0000184,1056,Boeing 787,08/21/2024,08/21/2024,LAX,MAA,270,294,162,-108,132,27,54,81,108,28,22,6,58,24,34,87,39,48,121,77,44,"{'F': 16, 'P': 11}","{'C': 22, 'J': 16, 'Z': 16}","{'Q': 24, 'R': 16, 'S': 8, 'T': 8, 'H': 16, 'M': 8}","{'Y': 8, 'A': 8, 'B': 4, 'D': 4, 'E': 4, 'G': 8, 'I': 4, 'K': 8, 'L': 4, 'N': 4, 'O': 4, 'U': 8, 'V': 4, 'W': 4, 'X': 4}"
INV-ZZ-0000449,SCH-ZZ-0000057,1057,Boeing 787,08/21/2024,08/21/2024,LAX,BLR,270,288,164,-106,124,27,54,81,108,31,14,17,57,53,4,84,36,48,116,61,55,"{'F': 16, 'P': 11}","{'C': 22, 'J': 16, 'Z': 16}","{'Q': 24, 'R': 16, 'S': 8, 'T': 8, 'H': 16, 'M': 8}","{'Y': 8, 'A': 8, 'B': 4, 'D': 4, 'E': 4, 'G': 8, 'I': 4, 'K': 8, 'L': 4, 'N': 4, 'O': 4, 'U': 8, 'V': 4, 'W': 4, 'X': 4}"
INV-ZZ-0000513,SCH-ZZ-0000121,1057,Boeing 787,08/21/2024,08/21/2024,LAX,BLR,270,288,199,-71,89,27,54,81,108,30,17,13,56,43,13,90,40,50,112,99,13,"{'F': 16, 'P': 11}","{'C': 22, 'J': 16, 'Z': 16}","{'Q': 24, 'R': 16, 'S': 8, 'T': 8, 'H': 16, 'M': 8}","{'Y': 8, 'A': 8, 'B': 4, 'D': 4, 'E': 4, 'G': 8, 'I': 4, 'K': 8, 'L': 4, 'N': 4, 'O': 4, 'U': 8, 'V': 4, 'W': 4, 'X': 4}"
INV-ZZ-0000577,SCH-ZZ-0000185,1057,Boeing 787,08/21/2024,08/21/2024,LAX,BLR,270,299,197,-73,102,27,54,81,108,32,19,13,58,43,15,83,80,3,126,55,71,"{'F': 16, 'P': 11}","{'C': 22, 'J': 16, 'Z': 16}","{'Q': 24, 'R': 16, 'S': 8, 'T': 8, 'H': 16, 'M': 8}","{'Y': 8, 'A': 8, 'B': 4, 'D': 4, 'E': 4, 'G': 8, 'I': 4, 'K': 8, 'L': 4, 'N': 4, 'O': 4, 'U': 8, 'V': 4, 'W': 4, 'X': 4}"
INV-ZZ-0000450,SCH-ZZ-0000058,1058,Boeing 787,08/21/2024,08/21/2024,LAX,BOM,270,303,165,-105,138,27,54,81,108,32,21,11,57,27,30,91,65,26,123,52,71,"{'F': 16, 'P': 11}","{'C': 22, 'J': 16, 'Z': 16}","{'Q': 24, 'R': 16, 'S': 8, 'T': 8, 'H': 16, 'M': 8}","{'Y': 8, 'A': 8, 'B': 4, 'D': 4, 'E': 4, 'G': 8, 'I': 4, 'K': 8, 'L': 4, 'N': 4, 'O': 4, 'U': 8, 'V': 4, 'W': 4, 'X': 4}"
INV-ZZ-0000514,SCH-ZZ-0000122,1058,Boeing 787,08/21/2024,08/21/2024,LAX,BOM,270,285,191,-79,94,27,54,81,108,28,20,8,56,46,10,89,73,16,112,52,60,"{'F': 16, 'P': 11}","{'C': 22, 'J': 16, 'Z': 16}","{'Q': 24, 'R': 16, 'S': 8, 'T': 8, 'H': 16, 'M': 8}","{'Y': 8, 'A': 8, 'B': 4, 'D': 4, 'E': 4, 'G': 8, 'I': 4, 'K': 8, 'L': 4, 'N': 4, 'O': 4, 'U': 8, 'V': 4, 'W': 4, 'X': 4}"
INV-ZZ-0000578,SCH-ZZ-0000186,1058,Boeing 787,08/21/2024,08/21/2024,LAX,BOM,270,291,189,-81,102,27,54,81,108,28,23,5,58,32,26,88,75,13,117,59,58,"{'F': 16, 'P': 11}","{'C': 22, 'J': 16, 'Z': 16}","{'Q': 24, 'R': 16, 'S': 8, 'T': 8, 'H': 16, 'M': 8}","{'Y': 8, 'A': 8, 'B': 4, 'D': 4, 'E': 4, 'G': 8, 'I': 4, 'K': 8, 'L': 4, 'N': 4, 'O': 4, 'U': 8, 'V': 4, 'W': 4, 'X': 4}"
INV-ZZ-0000451,SCH-ZZ-0000059,1059,Boeing 787,08/21/2024,08/21/2024,LAX,DUB,270,295,190,-80,105,27,54,81,108,30,27,3,58,40,18,86,76,10,121,47,74,"{'F': 16, 'P': 11}","{'C': 22, 'J': 16, 'Z': 16}","{'Q': 24, 'R': 16, 'S': 8, 'T': 8, 'H': 16, 'M': 8}","{'Y': 8, 'A': 8, 'B': 4, 'D': 4, 'E': 4, 'G': 8, 'I': 4, 'K': 8, 'L': 4, 'N': 4, 'O': 4, 'U': 8, 'V': 4, 'W': 4, 'X': 4}"
INV-ZZ-0000515,SCH-ZZ-0000123,1059,Boeing 787,08/21/2024,08/21/2024,LAX,DUB,270,291,231,-39,60,27,54,81,108,31,16,15,57,44,13,86,75,11,117,96,21,"{'F': 16, 'P': 11}","{'C': 22, 'J': 16, 'Z': 16}","{'Q': 24, 'R': 16, 'S': 8, 'T': 8, 'H': 16, 'M': 8}","{'Y': 8, 'A': 8, 'B': 4, 'D': 4, 'E': 4, 'G': 8, 'I': 4, 'K': 8, 'L': 4, 'N': 4, 'O': 4, 'U': 8, 'V': 4, 'W': 4, 'X': 4}"
INV-ZZ-0000579,SCH-ZZ-0000187,1059,Boeing 787,08/21/2024,08/21/2024,LAX,DUB,270,303,208,-62,95,27,54,81,108,31,13,18,58,40,18,89,62,27,125,93,32,"{'F': 16, 'P': 11}","{'C': 22, 'J': 16, 'Z': 16}","{'Q': 24, 'R': 16, 'S': 8, 'T': 8, 'H': 16, 'M': 8}","{'Y': 8, 'A': 8, 'B': 4, 'D': 4, 'E': 4, 'G': 8, 'I': 4, 'K': 8, 'L': 4, 'N': 4, 'O': 4, 'U': 8, 'V': 4, 'W': 4, 'X': 4}"
INV-ZZ-0000452,SCH-ZZ-0000060,1060,Boeing 787,08/21/2024,08/21/2024,LAX,VNS,270,288,228,-42,60,27,54,81,108,29,20,9,59,31,28,90,71,19,110,106,4,"{'F': 16, 'P': 11}","{'C': 22, 'J': 16, 'Z': 16}","{'Q': 24, 'R': 16, 'S': 8, 'T': 8, 'H': 16, 'M': 8}","{'Y': 8, 'A': 8, 'B': 4, 'D': 4, 'E': 4, 'G': 8, 'I': 4, 'K': 8, 'L': 4, 'N': 4, 'O': 4, 'U': 8, 'V': 4, 'W': 4, 'X': 4}"
INV-ZZ-0000516,SCH-ZZ-0000124,1060,Boeing 787,08/21/2024,08/21/2024,LAX,VNS,270,301,158,-112,143,27,54,81,108,29,19,10,59,44,15,91,39,52,122,56,66,"{'F': 16, 'P': 11}","{'C': 22, 'J': 16, 'Z': 16}","{'Q': 24, 'R': 16, 'S': 8, 'T': 8, 'H': 16, 'M': 8}","{'Y': 8, 'A': 8, 'B': 4, 'D': 4, 'E': 4, 'G': 8, 'I': 4, 'K': 8, 'L': 4, 'N': 4, 'O': 4, 'U': 8, 'V': 4, 'W': 4, 'X': 4}"
INV-ZZ-0000580,SCH-ZZ-0000188,1060,Boeing 787,08/21/2024,08/21/2024,LAX,VNS,270,282,160,-110,122,27,54,81,108,28,19,9,60,22,38,84,50,34,110,69,41,"{'F': 16, 'P': 11}","{'C': 22, 'J': 16, 'Z': 16}","{'Q': 24, 'R': 16, 'S': 8, 'T': 8, 'H': 16, 'M': 8}","{'Y': 8, 'A': 8, 'B': 4, 'D': 4, 'E': 4, 'G': 8, 'I': 4, 'K': 8, 'L': 4, 'N': 4, 'O': 4, 'U': 8, 'V': 4, 'W': 4, 'X': 4}"
INV-ZZ-0000453,SCH-ZZ-0000061,1061,Boeing 787,08/21/2024,08/21/2024,LAX,JFK,270,279,161,-109,118,27,54,81,108,29,24,5,59,30,29,82,67,15,109,40,69,"{'F': 16, 'P': 11}","{'C': 22, 'J': 16, 'Z': 16}","{'Q': 24, 'R': 16, 'S': 8, 'T': 8, 'H': 16, 'M': 8}","{'Y': 8, 'A': 8, 'B': 4, 'D': 4, 'E': 4, 'G': 8, 'I': 4, 'K': 8, 'L': 4, 'N': 4, 'O': 4, 'U': 8, 'V': 4, 'W': 4, 'X': 4}"
INV-ZZ-0000517,SCH-ZZ-0000125,1061,Boeing 787,08/21/2024,08/21/2024,LAX,JFK,270,291,181,-89,110,27,54,81,108,29,14,15,57,34,23,83,72,11,122,61,61,"{'F': 16, 'P': 11}","{'C': 22, 'J': 16, 'Z': 16}","{'Q': 24, 'R': 16, 'S': 8, 'T': 8, 'H': 16, 'M': 8}","{'Y': 8, 'A': 8, 'B': 4, 'D': 4, 'E': 4, 'G': 8, 'I': 4, 'K': 8, 'L': 4, 'N': 4, 'O': 4, 'U': 8, 'V': 4, 'W': 4, 'X': 4}"
INV-ZZ-0000581,SCH-ZZ-0000189,1061,Boeing 787,08/21/2024,08/21/2024,LAX,JFK,270,294,172,-98,122,27,54,81,108,29,11,18,56,24,32,82,67,15,127,70,57,"{'F': 16, 'P': 11}","{'C': 22, 'J': 16, 'Z': 16}","{'Q': 24, 'R': 16, 'S': 8, 'T': 8, 'H': 16, 'M': 8}","{'Y': 8, 'A': 8, 'B': 4, 'D': 4, 'E': 4, 'G': 8, 'I': 4, 'K': 8, 'L': 4, 'N': 4, 'O': 4, 'U': 8, 'V': 4, 'W': 4, 'X': 4}"
INV-ZZ-0000454,SCH-ZZ-0000062,1062,Boeing 787,08/21/2024,08/21/2024,LAX,DEL,270,287,202,-68,85,27,54,81,108,30,14,16,55,53,2,84,60,24,118,75,43,"{'F': 16, 'P': 11}","{'C': 22, 'J': 16, 'Z': 16}","{'Q': 24, 'R': 16, 'S': 8, 'T': 8, 'H': 16, 'M': 8}","{'Y': 8, 'A': 8, 'B': 4, 'D': 4, 'E': 4, 'G': 8, 'I': 4, 'K': 8, 'L': 4, 'N': 4, 'O': 4, 'U': 8, 'V': 4, 'W': 4, 'X': 4}"
INV-ZZ-0000518,SCH-ZZ-0000126,1062,Boeing 787,08/21/2024,08/21/2024,LAX,DEL,270,286,177,-93,109,27,54,81,108,28,22,6,57,36,21,88,68,20,113,51,62,"{'F': 16, 'P': 11}","{'C': 22, 'J': 16, 'Z': 16}","{'Q': 24, 'R': 16, 'S': 8, 'T': 8, 'H': 16, 'M': 8}","{'Y': 8, 'A': 8, 'B': 4, 'D': 4, 'E': 4, 'G': 8, 'I': 4, 'K': 8, 'L': 4, 'N': 4, 'O': 4, 'U': 8, 'V': 4, 'W': 4, 'X': 4}"
INV-ZZ-0000582,SCH-ZZ-0000190,1062,Boeing 787,08/21/2024,08/21/2024,LAX,DEL,270,279,185,-85,94,27,54,81,108,29,11,18,56,35,21,83,45,38,111,94,17,"{'F': 16, 'P': 11}","{'C': 22, 'J': 16, 'Z': 16}","{'Q': 24, 'R': 16, 'S': 8, 'T': 8, 'H': 16, 'M': 8}","{'Y': 8, 'A': 8, 'B': 4, 'D': 4, 'E': 4, 'G': 8, 'I': 4, 'K': 8, 'L': 4, 'N': 4, 'O': 4, 'U': 8, 'V': 4, 'W': 4, 'X': 4}"
INV-ZZ-0000589,SCH-ZZ-0000001,1001,Boeing 787,08/22/2024,08/22/2024,MAA,BLR,270,293,135,-135,158,27,54,81,108,28,22,6,57,28,29,89,35,54,119,50,69,"{'F': 16, 'P': 11}","{'C': 22, 'J': 16, 'Z': 16}","{'Q': 24, 'R': 16, 'S': 8, 'T': 8, 'H': 16, 'M': 8}","{'Y': 8, 'A': 8, 'B': 4, 'D': 4, 'E': 4, 'G': 8, 'I': 4, 'K': 8, 'L': 4, 'N': 4, 'O': 4, 'U': 8, 'V': 4, 'W': 4, 'X': 4}"
INV-ZZ-0000653,SCH-ZZ-0000065,1001,Boeing 787,08/22/2024,08/22/2024,MAA,BLR,270,292,171,-99,121,27,54,81,108,30,13,17,60,23,37,82,52,30,120,83,37,"{'F': 16, 'P': 11}","{'C': 22, 'J': 16, 'Z': 16}","{'Q': 24, 'R': 16, 'S': 8, 'T': 8, 'H': 16, 'M': 8}","{'Y': 8, 'A': 8, 'B': 4, 'D': 4, 'E': 4, 'G': 8, 'I': 4, 'K': 8, 'L': 4, 'N': 4, 'O': 4, 'U': 8, 'V': 4, 'W': 4, 'X': 4}"
INV-ZZ-0000717,SCH-ZZ-0000129,1001,Boeing 787,08/22/2024,08/22/2024,MAA,BLR,270,296,165,-105,131,27,54,81,108,32,15,17,56,24,32,83,40,43,125,86,39,"{'F': 16, 'P': 11}","{'C': 22, 'J': 16, 'Z': 16}","{'Q': 24, 'R': 16, 'S': 8, 'T': 8, 'H': 16, 'M': 8}","{'Y': 8, 'A': 8, 'B': 4, 'D': 4, 'E': 4, 'G': 8, 'I': 4, 'K': 8, 'L': 4, 'N': 4, 'O': 4, 'U': 8, 'V': 4, 'W': 4, 'X': 4}"
INV-ZZ-0000590,SCH-ZZ-0000002,1002,Boeing 787,08/22/2024,08/22/2024,MAA,BOM,270,301,165,-105,136,27,54,81,108,30,19,11,59,36,23,91,52,39,121,58,63,"{'F': 16, 'P': 11}","{'C': 22, 'J': 16, 'Z': 16}","{'Q': 24, 'R': 16, 'S': 8, 'T': 8, 'H': 16, 'M': 8}","{'Y': 8, 'A': 8, 'B': 4, 'D': 4, 'E': 4, 'G': 8, 'I': 4, 'K': 8, 'L': 4, 'N': 4, 'O': 4, 'U': 8, 'V': 4, 'W': 4, 'X': 4}"
INV-ZZ-0000654,SCH-ZZ-0000066,1002,Boeing 787,08/22/2024,08/22/2024,MAA,BOM,270,286,194,-76,92,27,54,81,108,30,24,6,55,42,13,83,56,27,118,72,46,"{'F': 16, 'P': 11}","{'C': 22, 'J': 16, 'Z': 16}","{'Q': 24, 'R': 16, 'S': 8, 'T': 8, 'H': 16, 'M': 8}","{'Y': 8, 'A': 8, 'B': 4, 'D': 4, 'E': 4, 'G': 8, 'I': 4, 'K': 8, 'L': 4, 'N': 4, 'O': 4, 'U': 8, 'V': 4, 'W': 4, 'X': 4}"
INV-ZZ-0000718,SCH-ZZ-0000130,1002,Boeing 787,08/22/2024,08/22/2024,MAA,BOM,270,294,216,-54,78,27,54,81,108,29,19,10,61,22,39,89,71,18,115,104,11,"{'F': 16, 'P': 11}","{'C': 22, 'J': 16, 'Z': 16}","{'Q': 24, 'R': 16, 'S': 8, 'T': 8, 'H': 16, 'M': 8}","{'Y': 8, 'A': 8, 'B': 4, 'D': 4, 'E': 4, 'G': 8, 'I': 4, 'K': 8, 'L': 4, 'N': 4, 'O': 4, 'U': 8, 'V': 4, 'W': 4, 'X': 4}"
INV-ZZ-0000591,SCH-ZZ-0000003,1003,Boeing 787,08/22/2024,08/22/2024,MAA,DUB,270,283,195,-75,88,27,54,81,108,28,25,3,55,39,16,87,73,14,113,58,55,"{'F': 16, 'P': 11}","{'C': 22, 'J': 16, 'Z': 16}","{'Q': 24, 'R': 16, 'S': 8, 'T': 8, 'H': 16, 'M': 8}","{'Y': 8, 'A': 8, 'B': 4, 'D': 4, 'E': 4, 'G': 8, 'I': 4, 'K': 8, 'L': 4, 'N': 4, 'O': 4, 'U': 8, 'V': 4, 'W': 4, 'X': 4}"
INV-ZZ-0000655,SCH-ZZ-0000067,1003,Boeing 787,08/22/2024,08/22/2024,MAA,DUB,270,305,235,-35,70,27,54,81,108,30,18,12,60,40,20,90,79,11,125,98,27,"{'F': 16, 'P': 11}","{'C': 22, 'J': 16, 'Z': 16}","{'Q': 24, 'R': 16, 'S': 8, 'T': 8, 'H': 16, 'M': 8}","{'Y': 8, 'A': 8, 'B': 4, 'D': 4, 'E': 4, 'G': 8, 'I': 4, 'K': 8, 'L': 4, 'N': 4, 'O': 4, 'U': 8, 'V': 4, 'W': 4, 'X': 4}"
INV-ZZ-0000719,SCH-ZZ-0000131,1003,Boeing 787,08/22/2024,08/22/2024,MAA,DUB,270,284,190,-80,94,27,54,81,108,31,22,9,55,44,11,84,81,3,114,43,71,"{'F': 16, 'P': 11}","{'C': 22, 'J': 16, 'Z': 16}","{'Q': 24, 'R': 16, 'S': 8, 'T': 8, 'H': 16, 'M': 8}","{'Y': 8, 'A': 8, 'B': 4, 'D': 4, 'E': 4, 'G': 8, 'I': 4, 'K': 8, 'L': 4, 'N': 4, 'O': 4, 'U': 8, 'V': 4, 'W': 4, 'X': 4}"
INV-ZZ-0000592,SCH-ZZ-0000004,1004,Boeing 787,08/22/2024,08/22/2024,MAA,VNS,270,296,188,-82,108,27,54,81,108,30,22,8,56,26,30,91,79,12,119,61,58,"{'F': 16, 'P': 11}","{'C': 22, 'J': 16, 'Z': 16}","{'Q': 24, 'R': 16, 'S': 8, 'T': 8, 'H': 16, 'M': 8}","{'Y': 8, 'A': 8, 'B': 4, 'D': 4, 'E': 4, 'G': 8, 'I': 4, 'K': 8, 'L': 4, 'N': 4, 'O': 4, 'U': 8, 'V': 4, 'W': 4, 'X': 4}"
INV-ZZ-0000656,SCH-ZZ-0000068,1004,Boeing 787,08/22/2024,08/22/2024,MAA,VNS,270,290,145,-125,145,27,54,81,108,31,11,20,60,22,38,88,49,39,111,63,48,"{'F': 16, 'P': 11}","{'C': 22, 'J': 16, 'Z': 16}","{'Q': 24, 'R': 16, 'S': 8, 'T': 8, 'H': 16, 'M': 8}","{'Y': 8, 'A': 8, 'B': 4, 'D': 4, 'E': 4, 'G': 8, 'I': 4, 'K': 8, 'L': 4, 'N': 4, 'O': 4, 'U': 8, 'V': 4, 'W': 4, 'X': 4}"
INV-ZZ-0000720,SCH-ZZ-0000132,1004,Boeing 787,08/22/2024,08/22/2024,MAA,VNS,270,293,204,-66,89,27,54,81,108,29,26,3,60,32,28,85,62,23,119,84,35,"{'F': 16, 'P': 11}","{'C': 22, 'J': 16, 'Z': 16}","{'Q': 24, 'R': 16, 'S': 8, 'T': 8, 'H': 16, 'M': 8}","{'Y': 8, 'A': 8, 'B': 4, 'D': 4, 'E': 4, 'G': 8, 'I': 4, 'K': 8, 'L': 4, 'N': 4, 'O': 4, 'U': 8, 'V': 4, 'W': 4, 'X': 4}"
INV-ZZ-0000593,SCH-ZZ-0000005,1005,Boeing 787,08/22/2024,08/22/2024,MAA,JFK,270,285,205,-65,80,27,54,81,108,29,26,3,61,53,8,84,50,34,111,76,35,"{'F': 16, 'P': 11}","{'C': 22, 'J': 16, 'Z': 16}","{'Q': 24, 'R': 16, 'S': 8, 'T': 8, 'H': 16, 'M': 8}","{'Y': 8, 'A': 8, 'B': 4, 'D': 4, 'E': 4, 'G': 8, 'I': 4, 'K': 8, 'L': 4, 'N': 4, 'O': 4, 'U': 8, 'V': 4, 'W': 4, 'X': 4}"
INV-ZZ-0000657,SCH-ZZ-0000069,1005,Boeing 787,08/22/2024,08/22/2024,MAA,JFK,270,296,194,-76,102,27,54,81,108,31,18,13,55,27,28,91,46,45,119,103,16,"{'F': 16, 'P': 11}","{'C': 22, 'J': 16, 'Z': 16}","{'Q': 24, 'R': 16, 'S': 8, 'T': 8, 'H': 16, 'M': 8}","{'Y': 8, 'A': 8, 'B': 4, 'D': 4, 'E': 4, 'G': 8, 'I': 4, 'K': 8, 'L': 4, 'N': 4, 'O': 4, 'U': 8, 'V': 4, 'W': 4, 'X': 4}"
INV-ZZ-0000721,SCH-ZZ-0000133,1005,Boeing 787,08/22/2024,08/22/2024,MAA,JFK,270,298,188,-82,110,27,54,81,108,32,18,14,56,42,14,85,36,49,125,92,33,"{'F': 16, 'P': 11}","{'C': 22, 'J': 16, 'Z': 16}","{'Q': 24, 'R': 16, 'S': 8, 'T': 8, 'H': 16, 'M': 8}","{'Y': 8, 'A': 8, 'B': 4, 'D': 4, 'E': 4, 'G': 8, 'I': 4, 'K': 8, 'L': 4, 'N': 4, 'O': 4, 'U': 8, 'V': 4, 'W': 4, 'X': 4}"
INV-ZZ-0000594,SCH-ZZ-0000006,1006,Boeing 787,08/22/2024,08/22/2024,MAA,DEL,270,292,207,-63,85,27,54,81,108,28,18,10,59,37,22,82,71,11,123,81,42,"{'F': 16, 'P': 11}","{'C': 22, 'J': 16, 'Z': 16}","{'Q': 24, 'R': 16, 'S': 8, 'T': 8, 'H': 16, 'M': 8}","{'Y': 8, 'A': 8, 'B': 4, 'D': 4, 'E': 4, 'G': 8, 'I': 4, 'K': 8, 'L': 4, 'N': 4, 'O': 4, 'U': 8, 'V': 4, 'W': 4, 'X': 4}"
INV-ZZ-0000658,SCH-ZZ-0000070,1006,Boeing 787,08/22/2024,08/22/2024,MAA,DEL,270,292,222,-48,70,27,54,81,108,30,14,16,56,37,19,87,74,13,119,97,22,"{'F': 16, 'P': 11}","{'C': 22, 'J': 16, 'Z': 16}","{'Q': 24, 'R': 16, 'S': 8, 'T': 8, 'H': 16, 'M': 8}","{'Y': 8, 'A': 8, 'B': 4, 'D': 4, 'E': 4, 'G': 8, 'I': 4, 'K': 8, 'L': 4, 'N': 4, 'O': 4, 'U': 8, 'V': 4, 'W': 4, 'X': 4}"
INV-ZZ-0000722,SCH-ZZ-0000134,1006,Boeing 787,08/22/2024,08/22/2024,MAA,DEL,270,292,235,-35,57,27,54,81,108,31,13,18,55,43,12,91,73,18,115,106,9,"{'F': 16, 'P': 11}","{'C': 22, 'J': 16, 'Z': 16}","{'Q': 24, 'R': 16, 'S': 8, 'T': 8, 'H': 16, 'M': 8}","{'Y': 8, 'A': 8, 'B': 4, 'D': 4, 'E': 4, 'G': 8, 'I': 4, 'K': 8, 'L': 4, 'N': 4, 'O': 4, 'U': 8, 'V': 4, 'W': 4, 'X': 4}"
INV-ZZ-0000595,SCH-ZZ-0000007,1007,Boeing 787,08/22/2024,08/22/2024,MAA,LAX,270,297,229,-41,68,27,54,81,108,28,22,6,61,45,16,89,81,8,119,81,38,"{'F': 16, 'P': 11}","{'C': 22, 'J': 16, 'Z': 16}","{'Q': 24, 'R': 16, 'S': 8, 'T': 8, 'H': 16, 'M': 8}","{'Y': 8, 'A': 8, 'B': 4, 'D': 4, 'E': 4, 'G': 8, 'I': 4, 'K': 8, 'L': 4, 'N': 4, 'O': 4, 'U': 8, 'V': 4, 'W': 4, 'X': 4}"
INV-ZZ-0000659,SCH-ZZ-0000071,1007,Boeing 787,08/22/2024,08/22/2024,MAA,LAX,270,287,205,-65,82,27,54,81,108,28,22,6,55,30,25,83,60,23,121,93,28,"{'F': 16, 'P': 11}","{'C': 22, 'J': 16, 'Z': 16}","{'Q': 24, 'R': 16, 'S': 8, 'T': 8, 'H': 16, 'M': 8}","{'Y': 8, 'A': 8, 'B': 4, 'D': 4, 'E': 4, 'G': 8, 'I': 4, 'K': 8, 'L': 4, 'N': 4, 'O': 4, 'U': 8, 'V': 4, 'W': 4, 'X': 4}"
INV-ZZ-0000723,SCH-ZZ-0000135,1007,Boeing 787,08/22/2024,08/22/2024,MAA,LAX,270,287,160,-110,127,27,54,81,108,31,20,11,55,24,31,83,62,21,118,54,64,"{'F': 16, 'P': 11}","{'C': 22, 'J': 16, 'Z': 16}","{'Q': 24, 'R': 16, 'S': 8, 'T': 8, 'H': 16, 'M': 8}","{'Y': 8, 'A': 8, 'B': 4, 'D': 4, 'E': 4, 'G': 8, 'I': 4, 'K': 8, 'L': 4, 'N': 4, 'O': 4, 'U': 8, 'V': 4, 'W': 4, 'X': 4}"
INV-ZZ-0000596,SCH-ZZ-0000008,1008,Boeing 787,08/22/2024,08/22/2024,BLR,MAA,270,300,179,-91,121,27,54,81,108,32,14,18,60,39,21,83,55,28,125,71,54,"{'F': 16, 'P': 11}","{'C': 22, 'J': 16, 'Z': 16}","{'Q': 24, 'R': 16, 'S': 8, 'T': 8, 'H': 16, 'M': 8}","{'Y': 8, 'A': 8, 'B': 4, 'D': 4, 'E': 4, 'G': 8, 'I': 4, 'K': 8, 'L': 4, 'N': 4, 'O': 4, 'U': 8, 'V': 4, 'W': 4, 'X': 4}"
INV-ZZ-0000660,SCH-ZZ-0000072,1008,Boeing 787,08/22/2024,08/22/2024,BLR,MAA,270,290,190,-80,100,27,54,81,108,29,18,11,61,31,30,89,77,12,111,64,47,"{'F': 16, 'P': 11}","{'C': 22, 'J': 16, 'Z': 16}","{'Q': 24, 'R': 16, 'S': 8, 'T': 8, 'H': 16, 'M': 8}","{'Y': 8, 'A': 8, 'B': 4, 'D': 4, 'E': 4, 'G': 8, 'I': 4, 'K': 8, 'L': 4, 'N': 4, 'O': 4, 'U': 8, 'V': 4, 'W': 4, 'X': 4}"
INV-ZZ-0000724,SCH-ZZ-0000136,1008,Boeing 787,08/22/2024,08/22/2024,BLR,MAA,270,300,191,-79,109,27,54,81,108,29,14,15,59,46,13,84,52,32,128,79,49,"{'F': 16, 'P': 11}","{'C': 22, 'J': 16, 'Z': 16}","{'Q': 24, 'R': 16, 'S': 8, 'T': 8, 'H': 16, 'M': 8}","{'Y': 8, 'A': 8, 'B': 4, 'D': 4, 'E': 4, 'G': 8, 'I': 4, 'K': 8, 'L': 4, 'N': 4, 'O': 4, 'U': 8, 'V': 4, 'W': 4, 'X': 4}"
INV-ZZ-0000598,SCH-ZZ-0000010,1010,Boeing 787,08/22/2024,08/22/2024,BLR,BOM,270,286,163,-107,123,27,54,81,108,28,12,16,60,52,8,82,42,40,116,57,59,"{'F': 16, 'P': 11}","{'C': 22, 'J': 16, 'Z': 16}","{'Q': 24, 'R': 16, 'S': 8, 'T': 8, 'H': 16, 'M': 8}","{'Y': 8, 'A': 8, 'B': 4, 'D': 4, 'E': 4, 'G': 8, 'I': 4, 'K': 8, 'L': 4, 'N': 4, 'O': 4, 'U': 8, 'V': 4, 'W': 4, 'X': 4}"
INV-ZZ-0000662,SCH-ZZ-0000074,1010,Boeing 787,08/22/2024,08/22/2024,BLR,BOM,270,294,159,-111,135,27,54,81,108,32,12,20,56,21,35,82,77,5,124,49,75,"{'F': 16, 'P': 11}","{'C': 22, 'J': 16, 'Z': 16}","{'Q': 24, 'R': 16, 'S': 8, 'T': 8, 'H': 16, 'M': 8}","{'Y': 8, 'A': 8, 'B': 4, 'D': 4, 'E': 4, 'G': 8, 'I': 4, 'K': 8, 'L': 4, 'N': 4, 'O': 4, 'U': 8, 'V': 4, 'W': 4, 'X': 4}"
INV-ZZ-0000726,SCH-ZZ-0000138,1010,Boeing 787,08/22/2024,08/22/2024,BLR,BOM,270,300,156,-114,144,27,54,81,108,30,16,14,55,23,32,88,48,40,127,69,58,"{'F': 16, 'P': 11}","{'C': 22, 'J': 16, 'Z': 16}","{'Q': 24, 'R': 16, 'S': 8, 'T': 8, 'H': 16, 'M': 8}","{'Y': 8, 'A': 8, 'B': 4, 'D': 4, 'E': 4, 'G': 8, 'I': 4, 'K': 8, 'L': 4, 'N': 4, 'O': 4, 'U': 8, 'V': 4, 'W': 4, 'X': 4}"
INV-ZZ-0000599,SCH-ZZ-0000011,1011,Boeing 787,08/22/2024,08/22/2024,BLR,DUB,270,295,160,-110,135,27,54,81,108,31,14,17,61,28,33,86,67,19,117,51,66,"{'F': 16, 'P': 11}","{'C': 22, 'J': 16, 'Z': 16}","{'Q': 24, 'R': 16, 'S': 8, 'T': 8, 'H': 16, 'M': 8}","{'Y': 8, 'A': 8, 'B': 4, 'D': 4, 'E': 4, 'G': 8, 'I': 4, 'K': 8, 'L': 4, 'N': 4, 'O': 4, 'U': 8, 'V': 4, 'W': 4, 'X': 4}"
INV-ZZ-0000663,SCH-ZZ-0000075,1011,Boeing 787,08/22/2024,08/22/2024,BLR,DUB,270,281,229,-41,52,27,54,81,108,29,16,13,59,51,8,83,55,28,110,107,3,"{'F': 16, 'P': 11}","{'C': 22, 'J': 16, 'Z': 16}","{'Q': 24, 'R': 16, 'S': 8, 'T': 8, 'H': 16, 'M': 8}","{'Y': 8, 'A': 8, 'B': 4, 'D': 4, 'E': 4, 'G': 8, 'I': 4, 'K': 8, 'L': 4, 'N': 4, 'O': 4, 'U': 8, 'V': 4, 'W': 4, 'X': 4}"
INV-ZZ-0000727,SCH-ZZ-0000139,1011,Boeing 787,08/22/2024,08/22/2024,BLR,DUB,270,292,187,-83,105,27,54,81,108,28,21,7,59,20,39,89,57,32,116,89,27,"{'F': 16, 'P': 11}","{'C': 22, 'J': 16, 'Z': 16}","{'Q': 24, 'R': 16, 'S': 8, 'T': 8, 'H': 16, 'M': 8}","{'Y': 8, 'A': 8, 'B': 4, 'D': 4, 'E': 4, 'G': 8, 'I': 4, 'K': 8, 'L': 4, 'N': 4, 'O': 4, 'U': 8, 'V': 4, 'W': 4, 'X': 4}"
INV-ZZ-0000600,SCH-ZZ-0000012,1012,Boeing 787,08/22/2024,08/22/2024,BLR,VNS,270,291,195,-75,96,27,54,81,108,32,15,17,57,42,15,90,44,46,112,94,18,"{'F': 16, 'P': 11}","{'C': 22, 'J': 16, 'Z': 16}","{'Q': 24, 'R': 16, 'S': 8, 'T': 8, 'H': 16, 'M': 8}","{'Y': 8, 'A': 8, 'B': 4, 'D': 4, 'E': 4, 'G': 8, 'I': 4, 'K': 8, 'L': 4, 'N': 4, 'O': 4, 'U': 8, 'V': 4, 'W': 4, 'X': 4}"
INV-ZZ-0000664,SCH-ZZ-0000076,1012,Boeing 787,08/22/2024,08/22/2024,BLR,VNS,270,285,155,-115,130,27,54,81,108,28,27,1,57,25,32,86,49,37,114,54,60,"{'F': 16, 'P': 11}","{'C': 22, 'J': 16, 'Z': 16}","{'Q': 24, 'R': 16, 'S': 8, 'T': 8, 'H': 16, 'M': 8}","{'Y': 8, 'A': 8, 'B': 4, 'D': 4, 'E': 4, 'G': 8, 'I': 4, 'K': 8, 'L': 4, 'N': 4, 'O': 4, 'U': 8, 'V': 4, 'W': 4, 'X': 4}"
INV-ZZ-0000728,SCH-ZZ-0000140,1012,Boeing 787,08/22/2024,08/22/2024,BLR,VNS,270,283,196,-74,87,27,54,81,108,28,18,10,60,34,26,83,50,33,112,94,18,"{'F': 16, 'P': 11}","{'C': 22, 'J': 16, 'Z': 16}","{'Q': 24, 'R': 16, 'S': 8, 'T': 8, 'H': 16, 'M': 8}","{'Y': 8, 'A': 8, 'B': 4, 'D': 4, 'E': 4, 'G': 8, 'I': 4, 'K': 8, 'L': 4, 'N': 4, 'O': 4, 'U': 8, 'V': 4, 'W': 4, 'X': 4}"
INV-ZZ-0000601,SCH-ZZ-0000013,1013,Boeing 787,08/22/2024,08/22/2024,BLR,JFK,270,288,177,-93,111,27,54,81,108,30,20,10,55,46,9,88,35,53,115,76,39,"{'F': 16, 'P': 11}","{'C': 22, 'J': 16, 'Z': 16}","{'Q': 24, 'R': 16, 'S': 8, 'T': 8, 'H': 16, 'M': 8}","{'Y': 8, 'A': 8, 'B': 4, 'D': 4, 'E': 4, 'G': 8, 'I': 4, 'K': 8, 'L': 4, 'N': 4, 'O': 4, 'U': 8, 'V': 4, 'W': 4, 'X': 4}"
INV-ZZ-0000665,SCH-ZZ-0000077,1013,Boeing 787,08/22/2024,08/22/2024,BLR,JFK,270,284,171,-99,113,27,54,81,108,28,24,4,57,35,22,90,69,21,109,43,66,"{'F': 16, 'P': 11}","{'C': 22, 'J': 16, 'Z': 16}","{'Q': 24, 'R': 16, 'S': 8, 'T': 8, 'H': 16, 'M': 8}","{'Y': 8, 'A': 8, 'B': 4, 'D': 4, 'E': 4, 'G': 8, 'I': 4, 'K': 8, 'L': 4, 'N': 4, 'O': 4, 'U': 8, 'V': 4, 'W': 4, 'X': 4}"
INV-ZZ-0000729,SCH-ZZ-0000141,1013,Boeing 787,08/22/2024,08/22/2024,BLR,JFK,270,290,191,-79,99,27,54,81,108,29,10,19,60,39,21,88,40,48,113,102,11,"{'F': 16, 'P': 11}","{'C': 22, 'J': 16, 'Z': 16}","{'Q': 24, 'R': 16, 'S': 8, 'T': 8, 'H': 16, 'M': 8}","{'Y': 8, 'A': 8, 'B': 4, 'D': 4, 'E': 4, 'G': 8, 'I': 4, 'K': 8, 'L': 4, 'N': 4, 'O': 4, 'U': 8, 'V': 4, 'W': 4, 'X': 4}"
INV-ZZ-0000602,SCH-ZZ-0000014,1014,Boeing 787,08/22/2024,08/22/2024,BLR,DEL,270,291,216,-54,75,27,54,81,108,32,25,7,57,29,28,91,79,12,111,83,28,"{'F': 16, 'P': 11}","{'C': 22, 'J': 16, 'Z': 16}","{'Q': 24, 'R': 16, 'S': 8, 'T': 8, 'H': 16, 'M': 8}","{'Y': 8, 'A': 8, 'B': 4, 'D': 4, 'E': 4, 'G': 8, 'I': 4, 'K': 8, 'L': 4, 'N': 4, 'O': 4, 'U': 8, 'V': 4, 'W': 4, 'X': 4}"
INV-ZZ-0000666,SCH-ZZ-0000078,1014,Boeing 787,08/22/2024,08/22/2024,BLR,DEL,270,298,158,-112,140,27,54,81,108,32,17,15,60,22,38,84,36,48,122,83,39,"{'F': 16, 'P': 11}","{'C': 22, 'J': 16, 'Z': 16}","{'Q': 24, 'R': 16, 'S': 8, 'T': 8, 'H': 16, 'M': 8}","{'Y': 8, 'A': 8, 'B': 4, 'D': 4, 'E': 4, 'G': 8, 'I': 4, 'K': 8, 'L': 4, 'N': 4, 'O': 4, 'U': 8, 'V': 4, 'W': 4, 'X': 4}"
INV-ZZ-0000730,SCH-ZZ-0000142,1014,Boeing 787,08/22/2024,08/22/2024,BLR,DEL,270,306,179,-91,127,27,54,81,108,28,24,4,61,34,27,91,37,54,126,84,42,"{'F': 16, 'P': 11}","{'C': 22, 'J': 16, 'Z': 16}","{'Q': 24, 'R': 16, 'S': 8, 'T': 8, 'H': 16, 'M': 8}","{'Y': 8, 'A': 8, 'B': 4, 'D': 4, 'E': 4, 'G': 8, 'I': 4, 'K': 8, 'L': 4, 'N': 4, 'O': 4, 'U': 8, 'V': 4, 'W': 4, 'X': 4}"
INV-ZZ-0000603,SCH-ZZ-0000015,1015,Boeing 787,08/22/2024,08/22/2024,BLR,LAX,270,291,206,-64,85,27,54,81,108,31,16,15,58,47,11,82,54,28,120,89,31,"{'F': 16, 'P': 11}","{'C': 22, 'J': 16, 'Z': 16}","{'Q': 24, 'R': 16, 'S': 8, 'T': 8, 'H': 16, 'M': 8}","{'Y': 8, 'A': 8, 'B': 4, 'D': 4, 'E': 4, 'G': 8, 'I': 4, 'K': 8, 'L': 4, 'N': 4, 'O': 4, 'U': 8, 'V': 4, 'W': 4, 'X': 4}"
INV-ZZ-0000667,SCH-ZZ-0000079,1015,Boeing 787,08/22/2024,08/22/2024,BLR,LAX,270,283,155,-115,128,27,54,81,108,32,15,17,55,27,28,84,48,36,112,65,47,"{'F': 16, 'P': 11}","{'C': 22, 'J': 16, 'Z': 16}","{'Q': 24, 'R': 16, 'S': 8, 'T': 8, 'H': 16, 'M': 8}","{'Y': 8, 'A': 8, 'B': 4, 'D': 4, 'E': 4, 'G': 8, 'I': 4, 'K': 8, 'L': 4, 'N': 4, 'O': 4, 'U': 8, 'V': 4, 'W': 4, 'X': 4}"
INV-ZZ-0000731,SCH-ZZ-0000143,1015,Boeing 787,08/22/2024,08/22/2024,BLR,LAX,270,297,176,-94,121,27,54,81,108,29,21,8,61,23,38,87,80,7,120,52,68,"{'F': 16, 'P': 11}","{'C': 22, 'J': 16, 'Z': 16}","{'Q': 24, 'R': 16, 'S': 8, 'T': 8, 'H': 16, 'M': 8}","{'Y': 8, 'A': 8, 'B': 4, 'D': 4, 'E': 4, 'G': 8, 'I': 4, 'K': 8, 'L': 4, 'N': 4, 'O': 4, 'U': 8, 'V': 4, 'W': 4, 'X': 4}"
INV-ZZ-0000604,SCH-ZZ-0000016,1016,Boeing 787,08/22/2024,08/22/2024,BOM,MAA,270,285,183,-87,102,27,54,81,108,32,10,22,58,41,17,86,38,48,109,94,15,"{'F': 16, 'P': 11}","{'C': 22, 'J': 16, 'Z': 16}","{'Q': 24, 'R': 16, 'S': 8, 'T': 8, 'H': 16, 'M': 8}","{'Y': 8, 'A': 8, 'B': 4, 'D': 4, 'E': 4, 'G': 8, 'I': 4, 'K': 8, 'L': 4, 'N': 4, 'O': 4, 'U': 8, 'V': 4, 'W': 4, 'X': 4}"
INV-ZZ-0000668,SCH-ZZ-0000080,1016,Boeing 787,08/22/2024,08/22/2024,BOM,MAA,270,299,146,-124,153,27,54,81,108,31,19,12,61,30,31,87,57,30,120,40,80,"{'F': 16, 'P': 11}","{'C': 22, 'J': 16, 'Z': 16}","{'Q': 24, 'R': 16, 'S': 8, 'T': 8, 'H': 16, 'M': 8}","{'Y': 8, 'A': 8, 'B': 4, 'D': 4, 'E': 4, 'G': 8, 'I': 4, 'K': 8, 'L': 4, 'N': 4, 'O': 4, 'U': 8, 'V': 4, 'W': 4, 'X': 4}"
INV-ZZ-0000732,SCH-ZZ-0000144,1016,Boeing 787,08/22/2024,08/22/2024,BOM,MAA,270,278,212,-58,66,27,54,81,108,28,22,6,55,23,32,84,69,15,111,98,13,"{'F': 16, 'P': 11}","{'C': 22, 'J': 16, 'Z': 16}","{'Q': 24, 'R': 16, 'S': 8, 'T': 8, 'H': 16, 'M': 8}","{'Y': 8, 'A': 8, 'B': 4, 'D': 4, 'E': 4, 'G': 8, 'I': 4, 'K': 8, 'L': 4, 'N': 4, 'O': 4, 'U': 8, 'V': 4, 'W': 4, 'X': 4}"
INV-ZZ-0000605,SCH-ZZ-0000017,1017,Boeing 787,08/22/2024,08/22/2024,BOM,BLR,270,293,173,-97,120,27,54,81,108,29,14,15,55,30,25,86,75,11,123,54,69,"{'F': 16, 'P': 11}","{'C': 22, 'J': 16, 'Z': 16}","{'Q': 24, 'R': 16, 'S': 8, 'T': 8, 'H': 16, 'M': 8}","{'Y': 8, 'A': 8, 'B': 4, 'D': 4, 'E': 4, 'G': 8, 'I': 4, 'K': 8, 'L': 4, 'N': 4, 'O': 4, 'U': 8, 'V': 4, 'W': 4, 'X': 4}"
INV-ZZ-0000669,SCH-ZZ-0000081,1017,Boeing 787,08/22/2024,08/22/2024,BOM,BLR,270,298,171,-99,127,27,54,81,108,30,25,5,61,46,15,86,47,39,121,53,68,"{'F': 16, 'P': 11}","{'C': 22, 'J': 16, 'Z': 16}","{'Q': 24, 'R': 16, 'S': 8, 'T': 8, 'H': 16, 'M': 8}","{'Y': 8, 'A': 8, 'B': 4, 'D': 4, 'E': 4, 'G': 8, 'I': 4, 'K': 8, 'L': 4, 'N': 4, 'O': 4, 'U': 8, 'V': 4, 'W': 4, 'X': 4}"
INV-ZZ-0000733,SCH-ZZ-0000145,1017,Boeing 787,08/22/2024,08/22/2024,BOM,BLR,270,300,178,-92,122,27,54,81,108,30,11,19,60,42,18,84,47,37,126,78,48,"{'F': 16, 'P': 11}","{'C': 22, 'J': 16, 'Z': 16}","{'Q': 24, 'R': 16, 'S': 8, 'T': 8, 'H': 16, 'M': 8}","{'Y': 8, 'A': 8, 'B': 4, 'D': 4, 'E': 4, 'G': 8, 'I': 4, 'K': 8, 'L': 4, 'N': 4, 'O': 4, 'U': 8, 'V': 4, 'W': 4, 'X': 4}"
INV-ZZ-0000607,SCH-ZZ-0000019,1019,Boeing 787,08/22/2024,08/22/2024,BOM,DUB,270,302,212,-58,90,27,54,81,108,32,18,14,57,47,10,87,53,34,126,94,32,"{'F': 16, 'P': 11}","{'C': 22, 'J': 16, 'Z': 16}","{'Q': 24, 'R': 16, 'S': 8, 'T': 8, 'H': 16, 'M': 8}","{'Y': 8, 'A': 8, 'B': 4, 'D': 4, 'E': 4, 'G': 8, 'I': 4, 'K': 8, 'L': 4, 'N': 4, 'O': 4, 'U': 8, 'V': 4, 'W': 4, 'X': 4}"
INV-ZZ-0000671,SCH-ZZ-0000083,1019,Boeing 787,08/22/2024,08/22/2024,BOM,DUB,270,297,164,-106,133,27,54,81,108,32,18,14,56,48,8,90,46,44,119,52,67,"{'F': 16, 'P': 11}","{'C': 22, 'J': 16, 'Z': 16}","{'Q': 24, 'R': 16, 'S': 8, 'T': 8, 'H': 16, 'M': 8}","{'Y': 8, 'A': 8, 'B': 4, 'D': 4, 'E': 4, 'G': 8, 'I': 4, 'K': 8, 'L': 4, 'N': 4, 'O': 4, 'U': 8, 'V': 4, 'W': 4, 'X': 4}"
INV-ZZ-0000735,SCH-ZZ-0000147,1019,Boeing 787,08/22/2024,08/22/2024,BOM,DUB,270,295,174,-96,121,27,54,81,108,32,16,16,55,49,6,86,56,30,122,53,69,"{'F': 16, 'P': 11}","{'C': 22, 'J': 16, 'Z': 16}","{'Q': 24, 'R': 16, 'S': 8, 'T': 8, 'H': 16, 'M': 8}","{'Y': 8, 'A': 8, 'B': 4, 'D': 4, 'E': 4, 'G': 8, 'I': 4, 'K': 8, 'L': 4, 'N': 4, 'O': 4, 'U': 8, 'V': 4, 'W': 4, 'X': 4}"
INV-ZZ-0000608,SCH-ZZ-0000020,1020,Boeing 787,08/22/2024,08/22/2024,BOM,VNS,270,286,220,-50,66,27,54,81,108,31,12,19,58,31,27,88,77,11,109,100,9,"{'F': 16, 'P': 11}","{'C': 22, 'J': 16, 'Z': 16}","{'Q': 24, 'R': 16, 'S': 8, 'T': 8, 'H': 16, 'M': 8}","{'Y': 8, 'A': 8, 'B': 4, 'D': 4, 'E': 4, 'G': 8, 'I': 4, 'K': 8, 'L': 4, 'N': 4, 'O': 4, 'U': 8, 'V': 4, 'W': 4, 'X': 4}"
INV-ZZ-0000672,SCH-ZZ-0000084,1020,Boeing 787,08/22/2024,08/22/2024,BOM,VNS,270,286,163,-107,123,27,54,81,108,29,11,18,60,27,33,86,38,48,111,87,24,"{'F': 16, 'P': 11}","{'C': 22, 'J': 16, 'Z': 16}","{'Q': 24, 'R': 16, 'S': 8, 'T': 8, 'H': 16, 'M': 8}","{'Y': 8, 'A': 8, 'B': 4, 'D': 4, 'E': 4, 'G': 8, 'I': 4, 'K': 8, 'L': 4, 'N': 4, 'O': 4, 'U': 8, 'V': 4, 'W': 4, 'X': 4}"
INV-ZZ-0000736,SCH-ZZ-0000148,1020,Boeing 787,08/22/2024,08/22/2024,BOM,VNS,270,290,171,-99,119,27,54,81,108,30,22,8,59,47,12,84,62,22,117,40,77,"{'F': 16, 'P': 11}","{'C': 22, 'J': 16, 'Z': 16}","{'Q': 24, 'R': 16, 'S': 8, 'T': 8, 'H': 16, 'M': 8}","{'Y': 8, 'A': 8, 'B': 4, 'D': 4, 'E': 4, 'G': 8, 'I': 4, 'K': 8, 'L': 4, 'N': 4, 'O': 4, 'U': 8, 'V': 4, 'W': 4, 'X': 4}"
INV-ZZ-0000609,SCH-ZZ-0000021,1021,Boeing 787,08/22/2024,08/22/2024,BOM,JFK,270,295,209,-61,86,27,54,81,108,30,26,4,59,39,20,90,68,22,116,76,40,"{'F': 16, 'P': 11}","{'C': 22, 'J': 16, 'Z': 16}","{'Q': 24, 'R': 16, 'S': 8, 'T': 8, 'H': 16, 'M': 8}","{'Y': 8, 'A': 8, 'B': 4, 'D': 4, 'E': 4, 'G': 8, 'I': 4, 'K': 8, 'L': 4, 'N': 4, 'O': 4, 'U': 8, 'V': 4, 'W': 4, 'X': 4}"
INV-ZZ-0000673,SCH-ZZ-0000085,1021,Boeing 787,08/22/2024,08/22/2024,BOM,JFK,270,296,213,-57,83,27,54,81,108,31,25,6,55,32,23,83,65,18,127,91,36,"{'F': 16, 'P': 11}","{'C': 22, 'J': 16, 'Z': 16}","{'Q': 24, 'R': 16, 'S': 8, 'T': 8, 'H': 16, 'M': 8}","{'Y': 8, 'A': 8, 'B': 4, 'D': 4, 'E': 4, 'G': 8, 'I': 4, 'K': 8, 'L': 4, 'N': 4, 'O': 4, 'U': 8, 'V': 4, 'W': 4, 'X': 4}"
INV-ZZ-0000737,SCH-ZZ-0000149,1021,Boeing 787,08/22/2024,08/22/2024,BOM,JFK,270,288,199,-71,89,27,54,81,108,29,17,12,60,41,19,90,58,32,109,83,26,"{'F': 16, 'P': 11}","{'C': 22, 'J': 16, 'Z': 16}","{'Q': 24, 'R': 16, 'S': 8, 'T': 8, 'H': 16, 'M': 8}","{'Y': 8, 'A': 8, 'B': 4, 'D': 4, 'E': 4, 'G': 8, 'I': 4, 'K': 8, 'L': 4, 'N': 4, 'O': 4, 'U': 8, 'V': 4, 'W': 4, 'X': 4}"
INV-ZZ-0000610,SCH-ZZ-0000022,1022,Boeing 787,08/22/2024,08/22/2024,BOM,DEL,270,287,209,-61,78,27,54,81,108,32,17,15,56,46,10,82,63,19,117,83,34,"{'F': 16, 'P': 11}","{'C': 22, 'J': 16, 'Z': 16}","{'Q': 24, 'R': 16, 'S': 8, 'T': 8, 'H': 16, 'M': 8}","{'Y': 8, 'A': 8, 'B': 4, 'D': 4, 'E': 4, 'G': 8, 'I': 4, 'K': 8, 'L': 4, 'N': 4, 'O': 4, 'U': 8, 'V': 4, 'W': 4, 'X': 4}"
INV-ZZ-0000674,SCH-ZZ-0000086,1022,Boeing 787,08/22/2024,08/22/2024,BOM,DEL,270,294,159,-111,135,27,54,81,108,32,18,14,55,39,16,84,36,48,123,66,57,"{'F': 16, 'P': 11}","{'C': 22, 'J': 16, 'Z': 16}","{'Q': 24, 'R': 16, 'S': 8, 'T': 8, 'H': 16, 'M': 8}","{'Y': 8, 'A': 8, 'B': 4, 'D': 4, 'E': 4, 'G': 8, 'I': 4, 'K': 8, 'L': 4, 'N': 4, 'O': 4, 'U': 8, 'V': 4, 'W': 4, 'X': 4}"
INV-ZZ-0000738,SCH-ZZ-0000150,1022,Boeing 787,08/22/2024,08/22/2024,BOM,DEL,270,285,217,-53,68,27,54,81,108,28,23,5,57,48,9,84,75,9,116,71,45,"{'F': 16, 'P': 11}","{'C': 22, 'J': 16, 'Z': 16}","{'Q': 24, 'R': 16, 'S': 8, 'T': 8, 'H': 16, 'M': 8}","{'Y': 8, 'A': 8, 'B': 4, 'D': 4, 'E': 4, 'G': 8, 'I': 4, 'K': 8, 'L': 4, 'N': 4, 'O': 4, 'U': 8, 'V': 4, 'W': 4, 'X': 4}"
INV-ZZ-0000611,SCH-ZZ-0000023,1023,Boeing 787,08/22/2024,08/22/2024,BOM,LAX,270,307,220,-50,87,27,54,81,108,30,11,19,61,42,19,89,68,21,127,99,28,"{'F': 16, 'P': 11}","{'C': 22, 'J': 16, 'Z': 16}","{'Q': 24, 'R': 16, 'S': 8, 'T': 8, 'H': 16, 'M': 8}","{'Y': 8, 'A': 8, 'B': 4, 'D': 4, 'E': 4, 'G': 8, 'I': 4, 'K': 8, 'L': 4, 'N': 4, 'O': 4, 'U': 8, 'V': 4, 'W': 4, 'X': 4}"
INV-ZZ-0000675,SCH-ZZ-0000087,1023,Boeing 787,08/22/2024,08/22/2024,BOM,LAX,270,287,232,-38,55,27,54,81,108,31,14,17,56,49,7,89,70,19,111,99,12,"{'F': 16, 'P': 11}","{'C': 22, 'J': 16, 'Z': 16}","{'Q': 24, 'R': 16, 'S': 8, 'T': 8, 'H': 16, 'M': 8}","{'Y': 8, 'A': 8, 'B': 4, 'D': 4, 'E': 4, 'G': 8, 'I': 4, 'K': 8, 'L': 4, 'N': 4, 'O': 4, 'U': 8, 'V': 4, 'W': 4, 'X': 4}"
INV-ZZ-0000739,SCH-ZZ-0000151,1023,Boeing 787,08/22/2024,08/22/2024,BOM,LAX,270,298,199,-71,99,27,54,81,108,32,13,19,55,43,12,89,53,36,122,90,32,"{'F': 16, 'P': 11}","{'C': 22, 'J': 16, 'Z': 16}","{'Q': 24, 'R': 16, 'S': 8, 'T': 8, 'H': 16, 'M': 8}","{'Y': 8, 'A': 8, 'B': 4, 'D': 4, 'E': 4, 'G': 8, 'I': 4, 'K': 8, 'L': 4, 'N': 4, 'O': 4, 'U': 8, 'V': 4, 'W': 4, 'X': 4}"
INV-ZZ-0000612,SCH-ZZ-0000024,1024,Boeing 787,08/22/2024,08/22/2024,DUB,MAA,270,278,235,-35,43,27,54,81,108,28,26,2,56,54,2,85,66,19,109,89,20,"{'F': 16, 'P': 11}","{'C': 22, 'J': 16, 'Z': 16}","{'Q': 24, 'R': 16, 'S': 8, 'T': 8, 'H': 16, 'M': 8}","{'Y': 8, 'A': 8, 'B': 4, 'D': 4, 'E': 4, 'G': 8, 'I': 4, 'K': 8, 'L': 4, 'N': 4, 'O': 4, 'U': 8, 'V': 4, 'W': 4, 'X': 4}"
INV-ZZ-0000676,SCH-ZZ-0000088,1024,Boeing 787,08/22/2024,08/22/2024,DUB,MAA,270,301,203,-67,98,27,54,81,108,32,22,10,61,45,16,90,71,19,118,65,53,"{'F': 16, 'P': 11}","{'C': 22, 'J': 16, 'Z': 16}","{'Q': 24, 'R': 16, 'S': 8, 'T': 8, 'H': 16, 'M': 8}","{'Y': 8, 'A': 8, 'B': 4, 'D': 4, 'E': 4, 'G': 8, 'I': 4, 'K': 8, 'L': 4, 'N': 4, 'O': 4, 'U': 8, 'V': 4, 'W': 4, 'X': 4}"
INV-ZZ-0000740,SCH-ZZ-0000152,1024,Boeing 787,08/22/2024,08/22/2024,DUB,MAA,270,289,222,-48,67,27,54,81,108,30,19,11,61,33,28,82,77,5,116,93,23,"{'F': 16, 'P': 11}","{'C': 22, 'J': 16, 'Z': 16}","{'Q': 24, 'R': 16, 'S': 8, 'T': 8, 'H': 16, 'M': 8}","{'Y': 8, 'A': 8, 'B': 4, 'D': 4, 'E': 4, 'G': 8, 'I': 4, 'K': 8, 'L': 4, 'N': 4, 'O': 4, 'U': 8, 'V': 4, 'W': 4, 'X': 4}"
INV-ZZ-0000613,SCH-ZZ-0000025,1025,Boeing 787,08/22/2024,08/22/2024,DUB,BLR,270,301,201,-69,100,27,54,81,108,31,20,11,56,25,31,88,75,13,126,81,45,"{'F': 16, 'P': 11}","{'C': 22, 'J': 16, 'Z': 16}","{'Q': 24, 'R': 16, 'S': 8, 'T': 8, 'H': 16, 'M': 8}","{'Y': 8, 'A': 8, 'B': 4, 'D': 4, 'E': 4, 'G': 8, 'I': 4, 'K': 8, 'L': 4, 'N': 4, 'O': 4, 'U': 8, 'V': 4, 'W': 4, 'X': 4}"
INV-ZZ-0000677,SCH-ZZ-0000089,1025,Boeing 787,08/22/2024,08/22/2024,DUB,BLR,270,296,204,-66,92,27,54,81,108,28,13,15,56,49,7,91,37,54,121,105,16,"{'F': 16, 'P': 11}","{'C': 22, 'J': 16, 'Z': 16}","{'Q': 24, 'R': 16, 'S': 8, 'T': 8, 'H': 16, 'M': 8}","{'Y': 8, 'A': 8, 'B': 4, 'D': 4, 'E': 4, 'G': 8, 'I': 4, 'K': 8, 'L': 4, 'N': 4, 'O': 4, 'U': 8, 'V': 4, 'W': 4, 'X': 4}"
INV-ZZ-0000741,SCH-ZZ-0000153,1025,Boeing 787,08/22/2024,08/22/2024,DUB,BLR,270,296,171,-99,125,27,54,81,108,28,10,18,60,25,35,88,73,15,120,63,57,"{'F': 16, 'P': 11}","{'C': 22, 'J': 16, 'Z': 16}","{'Q': 24, 'R': 16, 'S': 8, 'T': 8, 'H': 16, 'M': 8}","{'Y': 8, 'A': 8, 'B': 4, 'D': 4, 'E': 4, 'G': 8, 'I': 4, 'K': 8, 'L': 4, 'N': 4, 'O': 4, 'U': 8, 'V': 4, 'W': 4, 'X': 4}"
INV-ZZ-0000614,SCH-ZZ-0000026,1026,Boeing 787,08/22/2024,08/22/2024,DUB,BOM,270,297,246,-24,51,27,54,81,108,29,26,3,56,48,8,90,65,25,122,107,15,"{'F': 16, 'P': 11}","{'C': 22, 'J': 16, 'Z': 16}","{'Q': 24, 'R': 16, 'S': 8, 'T': 8, 'H': 16, 'M': 8}","{'Y': 8, 'A': 8, 'B': 4, 'D': 4, 'E': 4, 'G': 8, 'I': 4, 'K': 8, 'L': 4, 'N': 4, 'O': 4, 'U': 8, 'V': 4, 'W': 4, 'X': 4}"
INV-ZZ-0000678,SCH-ZZ-0000090,1026,Boeing 787,08/22/2024,08/22/2024,DUB,BOM,270,286,226,-44,60,27,54,81,108,30,21,9,58,44,14,82,76,6,116,85,31,"{'F': 16, 'P': 11}","{'C': 22, 'J': 16, 'Z': 16}","{'Q': 24, 'R': 16, 'S': 8, 'T': 8, 'H': 16, 'M': 8}","{'Y': 8, 'A': 8, 'B': 4, 'D': 4, 'E': 4, 'G': 8, 'I': 4, 'K': 8, 'L': 4, 'N': 4, 'O': 4, 'U': 8, 'V': 4, 'W': 4, 'X': 4}"
INV-ZZ-0000742,SCH-ZZ-0000154,1026,Boeing 787,08/22/2024,08/22/2024,DUB,BOM,270,289,138,-132,151,27,54,81,108,31,18,13,61,22,39,85,55,30,112,43,69,"{'F': 16, 'P': 11}","{'C': 22, 'J': 16, 'Z': 16}","{'Q': 24, 'R': 16, 'S': 8, 'T': 8, 'H': 16, 'M': 8}","{'Y': 8, 'A': 8, 'B': 4, 'D': 4, 'E': 4, 'G': 8, 'I': 4, 'K': 8, 'L': 4, 'N': 4, 'O': 4, 'U': 8, 'V': 4, 'W': 4, 'X': 4}"
INV-ZZ-0000616,SCH-ZZ-0000028,1028,Boeing 787,08/22/2024,08/22/2024,DUB,VNS,270,299,181,-89,118,27,54,81,108,32,19,13,58,31,27,83,54,29,126,77,49,"{'F': 16, 'P': 11}","{'C': 22, 'J': 16, 'Z': 16}","{'Q': 24, 'R': 16, 'S': 8, 'T': 8, 'H': 16, 'M': 8}","{'Y': 8, 'A': 8, 'B': 4, 'D': 4, 'E': 4, 'G': 8, 'I': 4, 'K': 8, 'L': 4, 'N': 4, 'O': 4, 'U': 8, 'V': 4, 'W': 4, 'X': 4}"
INV-ZZ-0000680,SCH-ZZ-0000092,1028,Boeing 787,08/22/2024,08/22/2024,DUB,VNS,270,304,201,-69,103,27,54,81,108,30,23,7,59,22,37,88,60,28,127,96,31,"{'F': 16, 'P': 11}","{'C': 22, 'J': 16, 'Z': 16}","{'Q': 24, 'R': 16, 'S': 8, 'T': 8, 'H': 16, 'M': 8}","{'Y': 8, 'A': 8, 'B': 4, 'D': 4, 'E': 4, 'G': 8, 'I': 4, 'K': 8, 'L': 4, 'N': 4, 'O': 4, 'U': 8, 'V': 4, 'W': 4, 'X': 4}"
INV-ZZ-0000744,SCH-ZZ-0000156,1028,Boeing 787,08/22/2024,08/22/2024,DUB,VNS,270,288,154,-116,134,27,54,81,108,31,20,11,56,52,4,84,39,45,117,43,74,"{'F': 16, 'P': 11}","{'C': 22, 'J': 16, 'Z': 16}","{'Q': 24, 'R': 16, 'S': 8, 'T': 8, 'H': 16, 'M': 8}","{'Y': 8, 'A': 8, 'B': 4, 'D': 4, 'E': 4, 'G': 8, 'I': 4, 'K': 8, 'L': 4, 'N': 4, 'O': 4, 'U': 8, 'V': 4, 'W': 4, 'X': 4}"
INV-ZZ-0000617,SCH-ZZ-0000029,1029,Boeing 787,08/22/2024,08/22/2024,DUB,JFK,270,300,184,-86,116,27,54,81,108,32,14,18,59,51,8,88,49,39,121,70,51,"{'F': 16, 'P': 11}","{'C': 22, 'J': 16, 'Z': 16}","{'Q': 24, 'R': 16, 'S': 8, 'T': 8, 'H': 16, 'M': 8}","{'Y': 8, 'A': 8, 'B': 4, 'D': 4, 'E': 4, 'G': 8, 'I': 4, 'K': 8, 'L': 4, 'N': 4, 'O': 4, 'U': 8, 'V': 4, 'W': 4, 'X': 4}"
INV-ZZ-0000681,SCH-ZZ-0000093,1029,Boeing 787,08/22/2024,08/22/2024,DUB,JFK,270,304,186,-84,118,27,54,81,108,30,22,8,59,53,6,87,36,51,128,75,53,"{'F': 16, 'P': 11}","{'C': 22, 'J': 16, 'Z': 16}","{'Q': 24, 'R': 16, 'S': 8, 'T': 8, 'H': 16, 'M': 8}","{'Y': 8, 'A': 8, 'B': 4, 'D': 4, 'E': 4, 'G': 8, 'I': 4, 'K': 8, 'L': 4, 'N': 4, 'O': 4, 'U': 8, 'V': 4, 'W': 4, 'X': 4}"
INV-ZZ-0000745,SCH-ZZ-0000157,1029,Boeing 787,08/22/2024,08/22/2024,DUB,JFK,270,301,214,-56,87,27,54,81,108,28,19,9,60,54,6,90,67,23,123,74,49,"{'F': 16, 'P': 11}","{'C': 22, 'J': 16, 'Z': 16}","{'Q': 24, 'R': 16, 'S': 8, 'T': 8, 'H': 16, 'M': 8}","{'Y': 8, 'A': 8, 'B': 4, 'D': 4, 'E': 4, 'G': 8, 'I': 4, 'K': 8, 'L': 4, 'N': 4, 'O': 4, 'U': 8, 'V': 4, 'W': 4, 'X': 4}"
INV-ZZ-0000618,SCH-ZZ-0000030,1030,Boeing 787,08/22/2024,08/22/2024,DUB,DEL,270,297,216,-54,81,27,54,81,108,32,19,13,58,38,20,82,55,27,125,104,21,"{'F': 16, 'P': 11}","{'C': 22, 'J': 16, 'Z': 16}","{'Q': 24, 'R': 16, 'S': 8, 'T': 8, 'H': 16, 'M': 8}","{'Y': 8, 'A': 8, 'B': 4, 'D': 4, 'E': 4, 'G': 8, 'I': 4, 'K': 8, 'L': 4, 'N': 4, 'O': 4, 'U': 8, 'V': 4, 'W': 4, 'X': 4}"
INV-ZZ-0000682,SCH-ZZ-0000094,1030,Boeing 787,08/22/2024,08/22/2024,DUB,DEL,270,291,156,-114,135,27,54,81,108,29,26,3,60,34,26,86,40,46,116,56,60,"{'F': 16, 'P': 11}","{'C': 22, 'J': 16, 'Z': 16}","{'Q': 24, 'R': 16, 'S': 8, 'T': 8, 'H': 16, 'M': 8}","{'Y': 8, 'A': 8, 'B': 4, 'D': 4, 'E': 4, 'G': 8, 'I': 4, 'K': 8, 'L': 4, 'N': 4, 'O': 4, 'U': 8, 'V': 4, 'W': 4, 'X': 4}"
INV-ZZ-0000746,SCH-ZZ-0000158,1030,Boeing 787,08/22/2024,08/22/2024,DUB,DEL,270,301,170,-100,131,27,54,81,108,28,26,2,58,34,24,91,40,51,124,70,54,"{'F': 16, 'P': 11}","{'C': 22, 'J': 16, 'Z': 16}","{'Q': 24, 'R': 16, 'S': 8, 'T': 8, 'H': 16, 'M': 8}","{'Y': 8, 'A': 8, 'B': 4, 'D': 4, 'E': 4, 'G': 8, 'I': 4, 'K': 8, 'L': 4, 'N': 4, 'O': 4, 'U': 8, 'V': 4, 'W': 4, 'X': 4}"
INV-ZZ-0000619,SCH-ZZ-0000031,1031,Boeing 787,08/22/2024,08/22/2024,DUB,LAX,270,278,174,-96,104,27,54,81,108,31,14,17,55,47,8,82,57,25,110,56,54,"{'F': 16, 'P': 11}","{'C': 22, 'J': 16, 'Z': 16}","{'Q': 24, 'R': 16, 'S': 8, 'T': 8, 'H': 16, 'M': 8}","{'Y': 8, 'A': 8, 'B': 4, 'D': 4, 'E': 4, 'G': 8, 'I': 4, 'K': 8, 'L': 4, 'N': 4, 'O': 4, 'U': 8, 'V': 4, 'W': 4, 'X': 4}"
INV-ZZ-0000683,SCH-ZZ-0000095,1031,Boeing 787,08/22/2024,08/22/2024,DUB,LAX,270,295,198,-72,97,27,54,81,108,29,20,9,61,43,18,86,41,45,119,94,25,"{'F': 16, 'P': 11}","{'C': 22, 'J': 16, 'Z': 16}","{'Q': 24, 'R': 16, 'S': 8, 'T': 8, 'H': 16, 'M': 8}","{'Y': 8, 'A': 8, 'B': 4, 'D': 4, 'E': 4, 'G': 8, 'I': 4, 'K': 8, 'L': 4, 'N': 4, 'O': 4, 'U': 8, 'V': 4, 'W': 4, 'X': 4}"
INV-ZZ-0000747,SCH-ZZ-0000159,1031,Boeing 787,08/22/2024,08/22/2024,DUB,LAX,270,280,170,-100,110,27,54,81,108,30,25,5,58,26,32,82,63,19,110,56,54,"{'F': 16, 'P': 11}","{'C': 22, 'J': 16, 'Z': 16}","{'Q': 24, 'R': 16, 'S': 8, 'T': 8, 'H': 16, 'M': 8}","{'Y': 8, 'A': 8, 'B': 4, 'D': 4, 'E': 4, 'G': 8, 'I': 4, 'K': 8, 'L': 4, 'N': 4, 'O': 4, 'U': 8, 'V': 4, 'W': 4, 'X': 4}"
INV-ZZ-0000620,SCH-ZZ-0000032,1032,Boeing 787,08/22/2024,08/22/2024,VNS,MAA,270,285,181,-89,104,27,54,81,108,30,22,8,57,48,9,84,64,20,114,47,67,"{'F': 16, 'P': 11}","{'C': 22, 'J': 16, 'Z': 16}","{'Q': 24, 'R': 16, 'S': 8, 'T': 8, 'H': 16, 'M': 8}","{'Y': 8, 'A': 8, 'B': 4, 'D': 4, 'E': 4, 'G': 8, 'I': 4, 'K': 8, 'L': 4, 'N': 4, 'O': 4, 'U': 8, 'V': 4, 'W': 4, 'X': 4}"
INV-ZZ-0000684,SCH-ZZ-0000096,1032,Boeing 787,08/22/2024,08/22/2024,VNS,MAA,270,294,149,-121,145,27,54,81,108,31,18,13,61,31,30,83,58,25,119,42,77,"{'F': 16, 'P': 11}","{'C': 22, 'J': 16, 'Z': 16}","{'Q': 24, 'R': 16, 'S': 8, 'T': 8, 'H': 16, 'M': 8}","{'Y': 8, 'A': 8, 'B': 4, 'D': 4, 'E': 4, 'G': 8, 'I': 4, 'K': 8, 'L': 4, 'N': 4, 'O': 4, 'U': 8, 'V': 4, 'W': 4, 'X': 4}"
INV-ZZ-0000748,SCH-ZZ-0000160,1032,Boeing 787,08/22/2024,08/22/2024,VNS,MAA,270,294,226,-44,68,27,54,81,108,31,25,6,61,41,20,83,64,19,119,96,23,"{'F': 16, 'P': 11}","{'C': 22, 'J': 16, 'Z': 16}","{'Q': 24, 'R': 16, 'S': 8, 'T': 8, 'H': 16, 'M': 8}","{'Y': 8, 'A': 8, 'B': 4, 'D': 4, 'E': 4, 'G': 8, 'I': 4, 'K': 8, 'L': 4, 'N': 4, 'O': 4, 'U': 8, 'V': 4, 'W': 4, 'X': 4}"
INV-ZZ-0000621,SCH-ZZ-0000033,1033,Boeing 787,08/22/2024,08/22/2024,VNS,BLR,270,297,182,-88,115,27,54,81,108,32,17,15,58,53,5,88,46,42,119,66,53,"{'F': 16, 'P': 11}","{'C': 22, 'J': 16, 'Z': 16}","{'Q': 24, 'R': 16, 'S': 8, 'T': 8, 'H': 16, 'M': 8}","{'Y': 8, 'A': 8, 'B': 4, 'D': 4, 'E': 4, 'G': 8, 'I': 4, 'K': 8, 'L': 4, 'N': 4, 'O': 4, 'U': 8, 'V': 4, 'W': 4, 'X': 4}"
INV-ZZ-0000685,SCH-ZZ-0000097,1033,Boeing 787,08/22/2024,08/22/2024,VNS,BLR,270,294,209,-61,85,27,54,81,108,30,24,6,56,53,3,88,53,35,120,79,41,"{'F': 16, 'P': 11}","{'C': 22, 'J': 16, 'Z': 16}","{'Q': 24, 'R': 16, 'S': 8, 'T': 8, 'H': 16, 'M': 8}","{'Y': 8, 'A': 8, 'B': 4, 'D': 4, 'E': 4, 'G': 8, 'I': 4, 'K': 8, 'L': 4, 'N': 4, 'O': 4, 'U': 8, 'V': 4, 'W': 4, 'X': 4}"
INV-ZZ-0000749,SCH-ZZ-0000161,1033,Boeing 787,08/22/2024,08/22/2024,VNS,BLR,270,298,211,-59,87,27,54,81,108,30,12,18,56,45,11,88,63,25,124,91,33,"{'F': 16, 'P': 11}","{'C': 22, 'J': 16, 'Z': 16}","{'Q': 24, 'R': 16, 'S': 8, 'T': 8, 'H': 16, 'M': 8}","{'Y': 8, 'A': 8, 'B': 4, 'D': 4, 'E': 4, 'G': 8, 'I': 4, 'K': 8, 'L': 4, 'N': 4, 'O': 4, 'U': 8, 'V': 4, 'W': 4, 'X': 4}"
INV-ZZ-0000622,SCH-ZZ-0000034,1034,Boeing 787,08/22/2024,08/22/2024,VNS,BOM,270,287,180,-90,107,27,54,81,108,28,24,4,57,21,36,87,75,12,115,60,55,"{'F': 16, 'P': 11}","{'C': 22, 'J': 16, 'Z': 16}","{'Q': 24, 'R': 16, 'S': 8, 'T': 8, 'H': 16, 'M': 8}","{'Y': 8, 'A': 8, 'B': 4, 'D': 4, 'E': 4, 'G': 8, 'I': 4, 'K': 8, 'L': 4, 'N': 4, 'O': 4, 'U': 8, 'V': 4, 'W': 4, 'X': 4}"
INV-ZZ-0000686,SCH-ZZ-0000098,1034,Boeing 787,08/22/2024,08/22/2024,VNS,BOM,270,295,165,-105,130,27,54,81,108,29,17,12,56,20,36,84,71,13,126,57,69,"{'F': 16, 'P': 11}","{'C': 22, 'J': 16, 'Z': 16}","{'Q': 24, 'R': 16, 'S': 8, 'T': 8, 'H': 16, 'M': 8}","{'Y': 8, 'A': 8, 'B': 4, 'D': 4, 'E': 4, 'G': 8, 'I': 4, 'K': 8, 'L': 4, 'N': 4, 'O': 4, 'U': 8, 'V': 4, 'W': 4, 'X': 4}"
INV-ZZ-0000750,SCH-ZZ-0000162,1034,Boeing 787,08/22/2024,08/22/2024,VNS,BOM,270,292,214,-56,78,27,54,81,108,31,22,9,55,50,5,88,73,15,118,69,49,"{'F': 16, 'P': 11}","{'C': 22, 'J': 16, 'Z': 16}","{'Q': 24, 'R': 16, 'S': 8, 'T': 8, 'H': 16, 'M': 8}","{'Y': 8, 'A': 8, 'B': 4, 'D': 4, 'E': 4, 'G': 8, 'I': 4, 'K': 8, 'L': 4, 'N': 4, 'O': 4, 'U': 8, 'V': 4, 'W': 4, 'X': 4}"
INV-ZZ-0000623,SCH-ZZ-0000035,1035,Boeing 787,08/22/2024,08/22/2024,VNS,DUB,270,295,230,-40,65,27,54,81,108,30,14,16,57,52,5,88,80,8,120,84,36,"{'F': 16, 'P': 11}","{'C': 22, 'J': 16, 'Z': 16}","{'Q': 24, 'R': 16, 'S': 8, 'T': 8, 'H': 16, 'M': 8}","{'Y': 8, 'A': 8, 'B': 4, 'D': 4, 'E': 4, 'G': 8, 'I': 4, 'K': 8, 'L': 4, 'N': 4, 'O': 4, 'U': 8, 'V': 4, 'W': 4, 'X': 4}"
INV-ZZ-0000687,SCH-ZZ-0000099,1035,Boeing 787,08/22/2024,08/22/2024,VNS,DUB,270,301,211,-59,90,27,54,81,108,28,27,1,61,42,19,87,36,51,125,106,19,"{'F': 16, 'P': 11}","{'C': 22, 'J': 16, 'Z': 16}","{'Q': 24, 'R': 16, 'S': 8, 'T': 8, 'H': 16, 'M': 8}","{'Y': 8, 'A': 8, 'B': 4, 'D': 4, 'E': 4, 'G': 8, 'I': 4, 'K': 8, 'L': 4, 'N': 4, 'O': 4, 'U': 8, 'V': 4, 'W': 4, 'X': 4}"
INV-ZZ-0000751,SCH-ZZ-0000163,1035,Boeing 787,08/22/2024,08/22/2024,VNS,DUB,270,287,178,-92,109,27,54,81,108,32,11,21,58,50,8,83,37,46,114,80,34,"{'F': 16, 'P': 11}","{'C': 22, 'J': 16, 'Z': 16}","{'Q': 24, 'R': 16, 'S': 8, 'T': 8, 'H': 16, 'M': 8}","{'Y': 8, 'A': 8, 'B': 4, 'D': 4, 'E': 4, 'G': 8, 'I': 4, 'K': 8, 'L': 4, 'N': 4, 'O': 4, 'U': 8, 'V': 4, 'W': 4, 'X': 4}"
INV-ZZ-0000625,SCH-ZZ-0000037,1037,Boeing 787,08/22/2024,08/22/2024,VNS,JFK,270,296,192,-78,104,27,54,81,108,31,11,20,58,43,15,89,66,23,118,72,46,"{'F': 16, 'P': 11}","{'C': 22, 'J': 16, 'Z': 16}","{'Q': 24, 'R': 16, 'S': 8, 'T': 8, 'H': 16, 'M': 8}","{'Y': 8, 'A': 8, 'B': 4, 'D': 4, 'E': 4, 'G': 8, 'I': 4, 'K': 8, 'L': 4, 'N': 4, 'O': 4, 'U': 8, 'V': 4, 'W': 4, 'X': 4}"
INV-ZZ-0000689,SCH-ZZ-0000101,1037,Boeing 787,08/22/2024,08/22/2024,VNS,JFK,270,294,181,-89,113,27,54,81,108,28,19,9,60,27,33,85,66,19,121,69,52,"{'F': 16, 'P': 11}","{'C': 22, 'J': 16, 'Z': 16}","{'Q': 24, 'R': 16, 'S': 8, 'T': 8, 'H': 16, 'M': 8}","{'Y': 8, 'A': 8, 'B': 4, 'D': 4, 'E': 4, 'G': 8, 'I': 4, 'K': 8, 'L': 4, 'N': 4, 'O': 4, 'U': 8, 'V': 4, 'W': 4, 'X': 4}"
INV-ZZ-0000753,SCH-ZZ-0000165,1037,Boeing 787,08/22/2024,08/22/2024,VNS,JFK,270,296,217,-53,79,27,54,81,108,32,17,15,59,46,13,88,64,24,117,90,27,"{'F': 16, 'P': 11}","{'C': 22, 'J': 16, 'Z': 16}","{'Q': 24, 'R': 16, 'S': 8, 'T': 8, 'H': 16, 'M': 8}","{'Y': 8, 'A': 8, 'B': 4, 'D': 4, 'E': 4, 'G': 8, 'I': 4, 'K': 8, 'L': 4, 'N': 4, 'O': 4, 'U': 8, 'V': 4, 'W': 4, 'X': 4}"
INV-ZZ-0000626,SCH-ZZ-0000038,1038,Boeing 787,08/22/2024,08/22/2024,VNS,DEL,270,289,214,-56,75,27,54,81,108,29,15,14,57,32,25,85,76,9,118,91,27,"{'F': 16, 'P': 11}","{'C': 22, 'J': 16, 'Z': 16}","{'Q': 24, 'R': 16, 'S': 8, 'T': 8, 'H': 16, 'M': 8}","{'Y': 8, 'A': 8, 'B': 4, 'D': 4, 'E': 4, 'G': 8, 'I': 4, 'K': 8, 'L': 4, 'N': 4, 'O': 4, 'U': 8, 'V': 4, 'W': 4, 'X': 4}"
INV-ZZ-0000690,SCH-ZZ-0000102,1038,Boeing 787,08/22/2024,08/22/2024,VNS,DEL,270,304,157,-113,147,27,54,81,108,28,24,4,60,32,28,90,61,29,126,40,86,"{'F': 16, 'P': 11}","{'C': 22, 'J': 16, 'Z': 16}","{'Q': 24, 'R': 16, 'S': 8, 'T': 8, 'H': 16, 'M': 8}","{'Y': 8, 'A': 8, 'B': 4, 'D': 4, 'E': 4, 'G': 8, 'I': 4, 'K': 8, 'L': 4, 'N': 4, 'O': 4, 'U': 8, 'V': 4, 'W': 4, 'X': 4}"
INV-ZZ-0000754,SCH-ZZ-0000166,1038,Boeing 787,08/22/2024,08/22/2024,VNS,DEL,270,295,223,-47,72,27,54,81,108,31,26,5,58,52,6,82,79,3,124,66,58,"{'F': 16, 'P': 11}","{'C': 22, 'J': 16, 'Z': 16}","{'Q': 24, 'R': 16, 'S': 8, 'T': 8, 'H': 16, 'M': 8}","{'Y': 8, 'A': 8, 'B': 4, 'D': 4, 'E': 4, 'G': 8, 'I': 4, 'K': 8, 'L': 4, 'N': 4, 'O': 4, 'U': 8, 'V': 4, 'W': 4, 'X': 4}"
INV-ZZ-0000627,SCH-ZZ-0000039,1039,Boeing 787,08/22/2024,08/22/2024,VNS,LAX,270,297,164,-106,133,27,54,81,108,29,16,13,59,27,32,84,68,16,125,53,72,"{'F': 16, 'P': 11}","{'C': 22, 'J': 16, 'Z': 16}","{'Q': 24, 'R': 16, 'S': 8, 'T': 8, 'H': 16, 'M': 8}","{'Y': 8, 'A': 8, 'B': 4, 'D': 4, 'E': 4, 'G': 8, 'I': 4, 'K': 8, 'L': 4, 'N': 4, 'O': 4, 'U': 8, 'V': 4, 'W': 4, 'X': 4}"
INV-ZZ-0000691,SCH-ZZ-0000103,1039,Boeing 787,08/22/2024,08/22/2024,VNS,LAX,270,290,160,-110,130,27,54,81,108,30,17,13,57,43,14,87,40,47,116,60,56,"{'F': 16, 'P': 11}","{'C': 22, 'J': 16, 'Z': 16}","{'Q': 24, 'R': 16, 'S': 8, 'T': 8, 'H': 16, 'M': 8}","{'Y': 8, 'A': 8, 'B': 4, 'D': 4, 'E': 4, 'G': 8, 'I': 4, 'K': 8, 'L': 4, 'N': 4, 'O': 4, 'U': 8, 'V': 4, 'W': 4, 'X': 4}"
INV-ZZ-0000755,SCH-ZZ-0000167,1039,Boeing 787,08/22/2024,08/22/2024,VNS,LAX,270,290,120,-150,170,27,54,81,108,29,17,12,56,26,30,85,35,50,120,42,78,"{'F': 16, 'P': 11}","{'C': 22, 'J': 16, 'Z': 16}","{'Q': 24, 'R': 16, 'S': 8, 'T': 8, 'H': 16, 'M': 8}","{'Y': 8, 'A': 8, 'B': 4, 'D': 4, 'E': 4, 'G': 8, 'I': 4, 'K': 8, 'L': 4, 'N': 4, 'O': 4, 'U': 8, 'V': 4, 'W': 4, 'X': 4}"
INV-ZZ-0000628,SCH-ZZ-0000040,1040,Boeing 787,08/22/2024,08/22/2024,JFK,MAA,270,280,178,-92,102,27,54,81,108,29,25,4,58,48,10,83,64,19,110,41,69,"{'F': 16, 'P': 11}","{'C': 22, 'J': 16, 'Z': 16}","{'Q': 24, 'R': 16, 'S': 8, 'T': 8, 'H': 16, 'M': 8}","{'Y': 8, 'A': 8, 'B': 4, 'D': 4, 'E': 4, 'G': 8, 'I': 4, 'K': 8, 'L': 4, 'N': 4, 'O': 4, 'U': 8, 'V': 4, 'W': 4, 'X': 4}"
INV-ZZ-0000692,SCH-ZZ-0000104,1040,Boeing 787,08/22/2024,08/22/2024,JFK,MAA,270,289,179,-91,110,27,54,81,108,29,14,15,60,31,29,91,71,20,109,63,46,"{'F': 16, 'P': 11}","{'C': 22, 'J': 16, 'Z': 16}","{'Q': 24, 'R': 16, 'S': 8, 'T': 8, 'H': 16, 'M': 8}","{'Y': 8, 'A': 8, 'B': 4, 'D': 4, 'E': 4, 'G': 8, 'I': 4, 'K': 8, 'L': 4, 'N': 4, 'O': 4, 'U': 8, 'V': 4, 'W': 4, 'X': 4}"
INV-ZZ-0000756,SCH-ZZ-0000168,1040,Boeing 787,08/22/2024,08/22/2024,JFK,MAA,270,293,187,-83,106,27,54,81,108,32,27,5,59,28,31,85,49,36,117,83,34,"{'F': 16, 'P': 11}","{'C': 22, 'J': 16, 'Z': 16}","{'Q': 24, 'R': 16, 'S': 8, 'T': 8, 'H': 16, 'M': 8}","{'Y': 8, 'A': 8, 'B': 4, 'D': 4, 'E': 4, 'G': 8, 'I': 4, 'K': 8, 'L': 4, 'N': 4, 'O': 4, 'U': 8, 'V': 4, 'W': 4, 'X': 4}"
INV-ZZ-0000629,SCH-ZZ-0000041,1041,Boeing 787,08/22/2024,08/22/2024,JFK,BLR,270,291,165,-105,126,27,54,81,108,29,14,15,59,24,35,83,54,29,120,73,47,"{'F': 16, 'P': 11}","{'C': 22, 'J': 16, 'Z': 16}","{'Q': 24, 'R': 16, 'S': 8, 'T': 8, 'H': 16, 'M': 8}","{'Y': 8, 'A': 8, 'B': 4, 'D': 4, 'E': 4, 'G': 8, 'I': 4, 'K': 8, 'L': 4, 'N': 4, 'O': 4, 'U': 8, 'V': 4, 'W': 4, 'X': 4}"
INV-ZZ-0000693,SCH-ZZ-0000105,1041,Boeing 787,08/22/2024,08/22/2024,JFK,BLR,270,286,161,-109,125,27,54,81,108,30,12,18,56,43,13,91,42,49,109,64,45,"{'F': 16, 'P': 11}","{'C': 22, 'J': 16, 'Z': 16}","{'Q': 24, 'R': 16, 'S': 8, 'T': 8, 'H': 16, 'M': 8}","{'Y': 8, 'A': 8, 'B': 4, 'D': 4, 'E': 4, 'G': 8, 'I': 4, 'K': 8, 'L': 4, 'N': 4, 'O': 4, 'U': 8, 'V': 4, 'W': 4, 'X': 4}"
INV-ZZ-0000757,SCH-ZZ-0000169,1041,Boeing 787,08/22/2024,08/22/2024,JFK,BLR,270,280,169,-101,111,27,54,81,108,28,27,1,56,41,15,85,46,39,111,55,56,"{'F': 16, 'P': 11}","{'C': 22, 'J': 16, 'Z': 16}","{'Q': 24, 'R': 16, 'S': 8, 'T': 8, 'H': 16, 'M': 8}","{'Y': 8, 'A': 8, 'B': 4, 'D': 4, 'E': 4, 'G': 8, 'I': 4, 'K': 8, 'L': 4, 'N': 4, 'O': 4, 'U': 8, 'V': 4, 'W': 4, 'X': 4}"
INV-ZZ-0000630,SCH-ZZ-0000042,1042,Boeing 787,08/22/2024,08/22/2024,JFK,BOM,270,289,240,-30,49,27,54,81,108,28,20,8,60,54,6,87,72,15,114,94,20,"{'F': 16, 'P': 11}","{'C': 22, 'J': 16, 'Z': 16}","{'Q': 24, 'R': 16, 'S': 8, 'T': 8, 'H': 16, 'M': 8}","{'Y': 8, 'A': 8, 'B': 4, 'D': 4, 'E': 4, 'G': 8, 'I': 4, 'K': 8, 'L': 4, 'N': 4, 'O': 4, 'U': 8, 'V': 4, 'W': 4, 'X': 4}"
INV-ZZ-0000694,SCH-ZZ-0000106,1042,Boeing 787,08/22/2024,08/22/2024,JFK,BOM,270,279,197,-73,82,27,54,81,108,30,13,17,57,29,28,82,54,28,110,101,9,"{'F': 16, 'P': 11}","{'C': 22, 'J': 16, 'Z': 16}","{'Q': 24, 'R': 16, 'S': 8, 'T': 8, 'H': 16, 'M': 8}","{'Y': 8, 'A': 8, 'B': 4, 'D': 4, 'E': 4, 'G': 8, 'I': 4, 'K': 8, 'L': 4, 'N': 4, 'O': 4, 'U': 8, 'V': 4, 'W': 4, 'X': 4}"
INV-ZZ-0000758,SCH-ZZ-0000170,1042,Boeing 787,08/22/2024,08/22/2024,JFK,BOM,270,303,193,-77,110,27,54,81,108,32,26,6,59,35,24,87,60,27,125,72,53,"{'F': 16, 'P': 11}","{'C': 22, 'J': 16, 'Z': 16}","{'Q': 24, 'R': 16, 'S': 8, 'T': 8, 'H': 16, 'M': 8}","{'Y': 8, 'A': 8, 'B': 4, 'D': 4, 'E': 4, 'G': 8, 'I': 4, 'K': 8, 'L': 4, 'N': 4, 'O': 4, 'U': 8, 'V': 4, 'W': 4, 'X': 4}"
INV-ZZ-0000631,SCH-ZZ-0000043,1043,Boeing 787,08/22/2024,08/22/2024,JFK,DUB,270,284,174,-96,110,27,54,81,108,29,25,4,55,29,26,83,36,47,117,84,33,"{'F': 16, 'P': 11}","{'C': 22, 'J': 16, 'Z': 16}","{'Q': 24, 'R': 16, 'S': 8, 'T': 8, 'H': 16, 'M': 8}","{'Y': 8, 'A': 8, 'B': 4, 'D': 4, 'E': 4, 'G': 8, 'I': 4, 'K': 8, 'L': 4, 'N': 4, 'O': 4, 'U': 8, 'V': 4, 'W': 4, 'X': 4}"
INV-ZZ-0000695,SCH-ZZ-0000107,1043,Boeing 787,08/22/2024,08/22/2024,JFK,DUB,270,287,180,-90,107,27,54,81,108,29,25,4,56,43,13,91,57,34,111,55,56,"{'F': 16, 'P': 11}","{'C': 22, 'J': 16, 'Z': 16}","{'Q': 24, 'R': 16, 'S': 8, 'T': 8, 'H': 16, 'M': 8}","{'Y': 8, 'A': 8, 'B': 4, 'D': 4, 'E': 4, 'G': 8, 'I': 4, 'K': 8, 'L': 4, 'N': 4, 'O': 4, 'U': 8, 'V': 4, 'W': 4, 'X': 4}"
INV-ZZ-0000759,SCH-ZZ-0000171,1043,Boeing 787,08/22/2024,08/22/2024,JFK,DUB,270,298,235,-35,63,27,54,81,108,29,12,17,59,49,10,91,75,16,119,99,20,"{'F': 16, 'P': 11}","{'C': 22, 'J': 16, 'Z': 16}","{'Q': 24, 'R': 16, 'S': 8, 'T': 8, 'H': 16, 'M': 8}","{'Y': 8, 'A': 8, 'B': 4, 'D': 4, 'E': 4, 'G': 8, 'I': 4, 'K': 8, 'L': 4, 'N': 4, 'O': 4, 'U': 8, 'V': 4, 'W': 4, 'X': 4}"
INV-ZZ-0000632,SCH-ZZ-0000044,1044,Boeing 787,08/22/2024,08/22/2024,JFK,VNS,270,289,193,-77,96,27,54,81,108,30,22,8,55,44,11,88,45,43,116,82,34,"{'F': 16, 'P': 11}","{'C': 22, 'J': 16, 'Z': 16}","{'Q': 24, 'R': 16, 'S': 8, 'T': 8, 'H': 16, 'M': 8}","{'Y': 8, 'A': 8, 'B': 4, 'D': 4, 'E': 4, 'G': 8, 'I': 4, 'K': 8, 'L': 4, 'N': 4, 'O': 4, 'U': 8, 'V': 4, 'W': 4, 'X': 4}"
INV-ZZ-0000696,SCH-ZZ-0000108,1044,Boeing 787,08/22/2024,08/22/2024,JFK,VNS,270,300,155,-115,145,27,54,81,108,30,15,15,55,35,20,89,51,38,126,54,72,"{'F': 16, 'P': 11}","{'C': 22, 'J': 16, 'Z': 16}","{'Q': 24, 'R': 16, 'S': 8, 'T': 8, 'H': 16, 'M': 8}","{'Y': 8, 'A': 8, 'B': 4, 'D': 4, 'E': 4, 'G': 8, 'I': 4, 'K': 8, 'L': 4, 'N': 4, 'O': 4, 'U': 8, 'V': 4, 'W': 4, 'X': 4}"
INV-ZZ-0000760,SCH-ZZ-0000172,1044,Boeing 787,08/22/2024,08/22/2024,JFK,VNS,270,287,145,-125,142,27,54,81,108,28,18,10,56,37,19,88,50,38,115,40,75,"{'F': 16, 'P': 11}","{'C': 22, 'J': 16, 'Z': 16}","{'Q': 24, 'R': 16, 'S': 8, 'T': 8, 'H': 16, 'M': 8}","{'Y': 8, 'A': 8, 'B': 4, 'D': 4, 'E': 4, 'G': 8, 'I': 4, 'K': 8, 'L': 4, 'N': 4, 'O': 4, 'U': 8, 'V': 4, 'W': 4, 'X': 4}"
INV-ZZ-0000634,SCH-ZZ-0000046,1046,Boeing 787,08/22/2024,08/22/2024,JFK,DEL,270,298,176,-94,122,27,54,81,108,30,22,8,56,39,17,86,38,48,126,77,49,"{'F': 16, 'P': 11}","{'C': 22, 'J': 16, 'Z': 16}","{'Q': 24, 'R': 16, 'S': 8, 'T': 8, 'H': 16, 'M': 8}","{'Y': 8, 'A': 8, 'B': 4, 'D': 4, 'E': 4, 'G': 8, 'I': 4, 'K': 8, 'L': 4, 'N': 4, 'O': 4, 'U': 8, 'V': 4, 'W': 4, 'X': 4}"
INV-ZZ-0000698,SCH-ZZ-0000110,1046,Boeing 787,08/22/2024,08/22/2024,JFK,DEL,270,287,240,-30,47,27,54,81,108,32,15,17,56,46,10,89,77,12,110,102,8,"{'F': 16, 'P': 11}","{'C': 22, 'J': 16, 'Z': 16}","{'Q': 24, 'R': 16, 'S': 8, 'T': 8, 'H': 16, 'M': 8}","{'Y': 8, 'A': 8, 'B': 4, 'D': 4, 'E': 4, 'G': 8, 'I': 4, 'K': 8, 'L': 4, 'N': 4, 'O': 4, 'U': 8, 'V': 4, 'W': 4, 'X': 4}"
INV-ZZ-0000762,SCH-ZZ-0000174,1046,Boeing 787,08/22/2024,08/22/2024,JFK,DEL,270,306,152,-118,154,27,54,81,108,30,16,14,61,41,20,87,48,39,128,47,81,"{'F': 16, 'P': 11}","{'C': 22, 'J': 16, 'Z': 16}","{'Q': 24, 'R': 16, 'S': 8, 'T': 8, 'H': 16, 'M': 8}","{'Y': 8, 'A': 8, 'B': 4, 'D': 4, 'E': 4, 'G': 8, 'I': 4, 'K': 8, 'L': 4, 'N': 4, 'O': 4, 'U': 8, 'V': 4, 'W': 4, 'X': 4}"
INV-ZZ-0000635,SCH-ZZ-0000047,1047,Boeing 787,08/22/2024,08/22/2024,JFK,LAX,270,275,206,-64,69,27,54,81,108,28,10,18,56,41,15,82,77,5,109,78,31,"{'F': 16, 'P': 11}","{'C': 22, 'J': 16, 'Z': 16}","{'Q': 24, 'R': 16, 'S': 8, 'T': 8, 'H': 16, 'M': 8}","{'Y': 8, 'A': 8, 'B': 4, 'D': 4, 'E': 4, 'G': 8, 'I': 4, 'K': 8, 'L': 4, 'N': 4, 'O': 4, 'U': 8, 'V': 4, 'W': 4, 'X': 4}"
INV-ZZ-0000699,SCH-ZZ-0000111,1047,Boeing 787,08/22/2024,08/22/2024,JFK,LAX,270,292,185,-85,107,27,54,81,108,31,14,17,55,54,1,82,37,45,124,80,44,"{'F': 16, 'P': 11}","{'C': 22, 'J': 16, 'Z': 16}","{'Q': 24, 'R': 16, 'S': 8, 'T': 8, 'H': 16, 'M': 8}","{'Y': 8, 'A': 8, 'B': 4, 'D': 4, 'E': 4, 'G': 8, 'I': 4, 'K': 8, 'L': 4, 'N': 4, 'O': 4, 'U': 8, 'V': 4, 'W': 4, 'X': 4}"
INV-ZZ-0000763,SCH-ZZ-0000175,1047,Boeing 787,08/22/2024,08/22/2024,JFK,LAX,270,285,159,-111,126,27,54,81,108,30,27,3,57,36,21,82,52,30,116,44,72,"{'F': 16, 'P': 11}","{'C': 22, 'J': 16, 'Z': 16}","{'Q': 24, 'R': 16, 'S': 8, 'T': 8, 'H': 16, 'M': 8}","{'Y': 8, 'A': 8, 'B': 4, 'D': 4, 'E': 4, 'G': 8, 'I': 4, 'K': 8, 'L': 4, 'N': 4, 'O': 4, 'U': 8, 'V': 4, 'W': 4, 'X': 4}"
INV-ZZ-0000636,SCH-ZZ-0000048,1048,Boeing 787,08/22/2024,08/22/2024,DEL,MAA,270,292,193,-77,99,27,54,81,108,30,24,6,55,23,32,88,71,17,119,75,44,"{'F': 16, 'P': 11}","{'C': 22, 'J': 16, 'Z': 16}","{'Q': 24, 'R': 16, 'S': 8, 'T': 8, 'H': 16, 'M': 8}","{'Y': 8, 'A': 8, 'B': 4, 'D': 4, 'E': 4, 'G': 8, 'I': 4, 'K': 8, 'L': 4, 'N': 4, 'O': 4, 'U': 8, 'V': 4, 'W': 4, 'X': 4}"
INV-ZZ-0000700,SCH-ZZ-0000112,1048,Boeing 787,08/22/2024,08/22/2024,DEL,MAA,270,293,182,-88,111,27,54,81,108,28,19,9,57,22,35,86,36,50,122,105,17,"{'F': 16, 'P': 11}","{'C': 22, 'J': 16, 'Z': 16}","{'Q': 24, 'R': 16, 'S': 8, 'T': 8, 'H': 16, 'M': 8}","{'Y': 8, 'A': 8, 'B': 4, 'D': 4, 'E': 4, 'G': 8, 'I': 4, 'K': 8, 'L': 4, 'N': 4, 'O': 4, 'U': 8, 'V': 4, 'W': 4, 'X': 4}"
INV-ZZ-0000764,SCH-ZZ-0000176,1048,Boeing 787,08/22/2024,08/22/2024,DEL,MAA,270,280,144,-126,136,27,54,81,108,28,16,12,61,21,40,82,57,25,109,50,59,"{'F': 16, 'P': 11}","{'C': 22, 'J': 16, 'Z': 16}","{'Q': 24, 'R': 16, 'S': 8, 'T': 8, 'H': 16, 'M': 8}","{'Y': 8, 'A': 8, 'B': 4, 'D': 4, 'E': 4, 'G': 8, 'I': 4, 'K': 8, 'L': 4, 'N': 4, 'O': 4, 'U': 8, 'V': 4, 'W': 4, 'X': 4}"
INV-ZZ-0000637,SCH-ZZ-0000049,1049,Boeing 787,08/22/2024,08/22/2024,DEL,BLR,270,283,150,-120,133,27,54,81,108,30,11,19,55,25,30,88,39,49,110,75,35,"{'F': 16, 'P': 11}","{'C': 22, 'J': 16, 'Z': 16}","{'Q': 24, 'R': 16, 'S': 8, 'T': 8, 'H': 16, 'M': 8}","{'Y': 8, 'A': 8, 'B': 4, 'D': 4, 'E': 4, 'G': 8, 'I': 4, 'K': 8, 'L': 4, 'N': 4, 'O': 4, 'U': 8, 'V': 4, 'W': 4, 'X': 4}"
INV-ZZ-0000701,SCH-ZZ-0000113,1049,Boeing 787,08/22/2024,08/22/2024,DEL,BLR,270,301,248,-22,53,27,54,81,108,30,21,9,60,50,10,85,73,12,126,104,22,"{'F': 16, 'P': 11}","{'C': 22, 'J': 16, 'Z': 16}","{'Q': 24, 'R': 16, 'S': 8, 'T': 8, 'H': 16, 'M': 8}","{'Y': 8, 'A': 8, 'B': 4, 'D': 4, 'E': 4, 'G': 8, 'I': 4, 'K': 8, 'L': 4, 'N': 4, 'O': 4, 'U': 8, 'V': 4, 'W': 4, 'X': 4}"
INV-ZZ-0000765,SCH-ZZ-0000177,1049,Boeing 787,08/22/2024,08/22/2024,DEL,BLR,270,287,203,-67,84,27,54,81,108,28,22,6,55,46,9,84,66,18,120,69,51,"{'F': 16, 'P': 11}","{'C': 22, 'J': 16, 'Z': 16}","{'Q': 24, 'R': 16, 'S': 8, 'T': 8, 'H': 16, 'M': 8}","{'Y': 8, 'A': 8, 'B': 4, 'D': 4, 'E': 4, 'G': 8, 'I': 4, 'K': 8, 'L': 4, 'N': 4, 'O': 4, 'U': 8, 'V': 4, 'W': 4, 'X': 4}"
INV-ZZ-0000638,SCH-ZZ-0000050,1050,Boeing 787,08/22/2024,08/22/2024,DEL,BOM,270,286,190,-80,96,27,54,81,108,28,27,1,55,46,9,87,65,22,116,52,64,"{'F': 16, 'P': 11}","{'C': 22, 'J': 16, 'Z': 16}","{'Q': 24, 'R': 16, 'S': 8, 'T': 8, 'H': 16, 'M': 8}","{'Y': 8, 'A': 8, 'B': 4, 'D': 4, 'E': 4, 'G': 8, 'I': 4, 'K': 8, 'L': 4, 'N': 4, 'O': 4, 'U': 8, 'V': 4, 'W': 4, 'X': 4}"
INV-ZZ-0000702,SCH-ZZ-0000114,1050,Boeing 787,08/22/2024,08/22/2024,DEL,BOM,270,284,208,-62,76,27,54,81,108,32,13,19,55,43,12,82,74,8,115,78,37,"{'F': 16, 'P': 11}","{'C': 22, 'J': 16, 'Z': 16}","{'Q': 24, 'R': 16, 'S': 8, 'T': 8, 'H': 16, 'M': 8}","{'Y': 8, 'A': 8, 'B': 4, 'D': 4, 'E': 4, 'G': 8, 'I': 4, 'K': 8, 'L': 4, 'N': 4, 'O': 4, 'U': 8, 'V': 4, 'W': 4, 'X': 4}"
INV-ZZ-0000766,SCH-ZZ-0000178,1050,Boeing 787,08/22/2024,08/22/2024,DEL,BOM,270,289,194,-76,95,27,54,81,108,30,10,20,59,34,25,86,51,35,114,99,15,"{'F': 16, 'P': 11}","{'C': 22, 'J': 16, 'Z': 16}","{'Q': 24, 'R': 16, 'S': 8, 'T': 8, 'H': 16, 'M': 8}","{'Y': 8, 'A': 8, 'B': 4, 'D': 4, 'E': 4, 'G': 8, 'I': 4, 'K': 8, 'L': 4, 'N': 4, 'O': 4, 'U': 8, 'V': 4, 'W': 4, 'X': 4}"
INV-ZZ-0000639,SCH-ZZ-0000051,1051,Boeing 787,08/22/2024,08/22/2024,DEL,DUB,270,298,190,-80,108,27,54,81,108,28,14,14,57,51,6,91,66,25,122,59,63,"{'F': 16, 'P': 11}","{'C': 22, 'J': 16, 'Z': 16}","{'Q': 24, 'R': 16, 'S': 8, 'T': 8, 'H': 16, 'M': 8}","{'Y': 8, 'A': 8, 'B': 4, 'D': 4, 'E': 4, 'G': 8, 'I': 4, 'K': 8, 'L': 4, 'N': 4, 'O': 4, 'U': 8, 'V': 4, 'W': 4, 'X': 4}"
INV-ZZ-0000703,SCH-ZZ-0000115,1051,Boeing 787,08/22/2024,08/22/2024,DEL,DUB,270,298,219,-51,79,27,54,81,108,28,12,16,58,53,5,91,52,39,121,102,19,"{'F': 16, 'P': 11}","{'C': 22, 'J': 16, 'Z': 16}","{'Q': 24, 'R': 16, 'S': 8, 'T': 8, 'H': 16, 'M': 8}","{'Y': 8, 'A': 8, 'B': 4, 'D': 4, 'E': 4, 'G': 8, 'I': 4, 'K': 8, 'L': 4, 'N': 4, 'O': 4, 'U': 8, 'V': 4, 'W': 4, 'X': 4}"
INV-ZZ-0000767,SCH-ZZ-0000179,1051,Boeing 787,08/22/2024,08/22/2024,DEL,DUB,270,282,135,-135,147,27,54,81,108,29,15,14,59,36,23,83,36,47,111,48,63,"{'F': 16, 'P': 11}","{'C': 22, 'J': 16, 'Z': 16}","{'Q': 24, 'R': 16, 'S': 8, 'T': 8, 'H': 16, 'M': 8}","{'Y': 8, 'A': 8, 'B': 4, 'D': 4, 'E': 4, 'G': 8, 'I': 4, 'K': 8, 'L': 4, 'N': 4, 'O': 4, 'U': 8, 'V': 4, 'W': 4, 'X': 4}"
INV-ZZ-0000640,SCH-ZZ-0000052,1052,Boeing 787,08/22/2024,08/22/2024,DEL,VNS,270,298,148,-122,150,27,54,81,108,30,13,17,55,23,32,88,57,31,125,55,70,"{'F': 16, 'P': 11}","{'C': 22, 'J': 16, 'Z': 16}","{'Q': 24, 'R': 16, 'S': 8, 'T': 8, 'H': 16, 'M': 8}","{'Y': 8, 'A': 8, 'B': 4, 'D': 4, 'E': 4, 'G': 8, 'I': 4, 'K': 8, 'L': 4, 'N': 4, 'O': 4, 'U': 8, 'V': 4, 'W': 4, 'X': 4}"
INV-ZZ-0000704,SCH-ZZ-0000116,1052,Boeing 787,08/22/2024,08/22/2024,DEL,VNS,270,283,211,-59,72,27,54,81,108,32,10,22,55,46,9,84,51,33,112,104,8,"{'F': 16, 'P': 11}","{'C': 22, 'J': 16, 'Z': 16}","{'Q': 24, 'R': 16, 'S': 8, 'T': 8, 'H': 16, 'M': 8}","{'Y': 8, 'A': 8, 'B': 4, 'D': 4, 'E': 4, 'G': 8, 'I': 4, 'K': 8, 'L': 4, 'N': 4, 'O': 4, 'U': 8, 'V': 4, 'W': 4, 'X': 4}"
INV-ZZ-0000768,SCH-ZZ-0000180,1052,Boeing 787,08/22/2024,08/22/2024,DEL,VNS,270,285,162,-108,123,27,54,81,108,32,13,19,58,45,13,83,48,35,112,56,56,"{'F': 16, 'P': 11}","{'C': 22, 'J': 16, 'Z': 16}","{'Q': 24, 'R': 16, 'S': 8, 'T': 8, 'H': 16, 'M': 8}","{'Y': 8, 'A': 8, 'B': 4, 'D': 4, 'E': 4, 'G': 8, 'I': 4, 'K': 8, 'L': 4, 'N': 4, 'O': 4, 'U': 8, 'V': 4, 'W': 4, 'X': 4}"
INV-ZZ-0000641,SCH-ZZ-0000053,1053,Boeing 787,08/22/2024,08/22/2024,DEL,JFK,270,295,239,-31,56,27,54,81,108,30,22,8,58,48,10,88,76,12,119,93,26,"{'F': 16, 'P': 11}","{'C': 22, 'J': 16, 'Z': 16}","{'Q': 24, 'R': 16, 'S': 8, 'T': 8, 'H': 16, 'M': 8}","{'Y': 8, 'A': 8, 'B': 4, 'D': 4, 'E': 4, 'G': 8, 'I': 4, 'K': 8, 'L': 4, 'N': 4, 'O': 4, 'U': 8, 'V': 4, 'W': 4, 'X': 4}"
INV-ZZ-0000705,SCH-ZZ-0000117,1053,Boeing 787,08/22/2024,08/22/2024,DEL,JFK,270,296,182,-88,114,27,54,81,108,30,20,10,57,40,17,83,46,37,126,76,50,"{'F': 16, 'P': 11}","{'C': 22, 'J': 16, 'Z': 16}","{'Q': 24, 'R': 16, 'S': 8, 'T': 8, 'H': 16, 'M': 8}","{'Y': 8, 'A': 8, 'B': 4, 'D': 4, 'E': 4, 'G': 8, 'I': 4, 'K': 8, 'L': 4, 'N': 4, 'O': 4, 'U': 8, 'V': 4, 'W': 4, 'X': 4}"
INV-ZZ-0000769,SCH-ZZ-0000181,1053,Boeing 787,08/22/2024,08/22/2024,DEL,JFK,270,303,169,-101,134,27,54,81,108,32,12,20,57,33,24,86,50,36,128,74,54,"{'F': 16, 'P': 11}","{'C': 22, 'J': 16, 'Z': 16}","{'Q': 24, 'R': 16, 'S': 8, 'T': 8, 'H': 16, 'M': 8}","{'Y': 8, 'A': 8, 'B': 4, 'D': 4, 'E': 4, 'G': 8, 'I': 4, 'K': 8, 'L': 4, 'N': 4, 'O': 4, 'U': 8, 'V': 4, 'W': 4, 'X': 4}"
INV-ZZ-0000643,SCH-ZZ-0000055,1055,Boeing 787,08/22/2024,08/22/2024,DEL,LAX,270,296,202,-68,94,27,54,81,108,31,16,15,57,53,4,88,53,35,120,80,40,"{'F': 16, 'P': 11}","{'C': 22, 'J': 16, 'Z': 16}","{'Q': 24, 'R': 16, 'S': 8, 'T': 8, 'H': 16, 'M': 8}","{'Y': 8, 'A': 8, 'B': 4, 'D': 4, 'E': 4, 'G': 8, 'I': 4, 'K': 8, 'L': 4, 'N': 4, 'O': 4, 'U': 8, 'V': 4, 'W': 4, 'X': 4}"
INV-ZZ-0000707,SCH-ZZ-0000119,1055,Boeing 787,08/22/2024,08/22/2024,DEL,LAX,270,304,232,-38,72,27,54,81,108,31,15,16,56,49,7,90,76,14,127,92,35,"{'F': 16, 'P': 11}","{'C': 22, 'J': 16, 'Z': 16}","{'Q': 24, 'R': 16, 'S': 8, 'T': 8, 'H': 16, 'M': 8}","{'Y': 8, 'A': 8, 'B': 4, 'D': 4, 'E': 4, 'G': 8, 'I': 4, 'K': 8, 'L': 4, 'N': 4, 'O': 4, 'U': 8, 'V': 4, 'W': 4, 'X': 4}"
INV-ZZ-0000771,SCH-ZZ-0000183,1055,Boeing 787,08/22/2024,08/22/2024,DEL,LAX,270,304,163,-107,141,27,54,81,108,29,19,10,60,24,36,91,59,32,124,61,63,"{'F': 16, 'P': 11}","{'C': 22, 'J': 16, 'Z': 16}","{'Q': 24, 'R': 16, 'S': 8, 'T': 8, 'H': 16, 'M': 8}","{'Y': 8, 'A': 8, 'B': 4, 'D': 4, 'E': 4, 'G': 8, 'I': 4, 'K': 8, 'L': 4, 'N': 4, 'O': 4, 'U': 8, 'V': 4, 'W': 4, 'X': 4}"
INV-ZZ-0000644,SCH-ZZ-0000056,1056,Boeing 787,08/22/2024,08/22/2024,LAX,MAA,270,303,180,-90,123,27,54,81,108,30,17,13,56,23,33,91,55,36,126,85,41,"{'F': 16, 'P': 11}","{'C': 22, 'J': 16, 'Z': 16}","{'Q': 24, 'R': 16, 'S': 8, 'T': 8, 'H': 16, 'M': 8}","{'Y': 8, 'A': 8, 'B': 4, 'D': 4, 'E': 4, 'G': 8, 'I': 4, 'K': 8, 'L': 4, 'N': 4, 'O': 4, 'U': 8, 'V': 4, 'W': 4, 'X': 4}"
INV-ZZ-0000708,SCH-ZZ-0000120,1056,Boeing 787,08/22/2024,08/22/2024,LAX,MAA,270,287,198,-72,89,27,54,81,108,30,16,14,60,44,16,88,44,44,109,94,15,"{'F': 16, 'P': 11}","{'C': 22, 'J': 16, 'Z': 16}","{'Q': 24, 'R': 16, 'S': 8, 'T': 8, 'H': 16, 'M': 8}","{'Y': 8, 'A': 8, 'B': 4, 'D': 4, 'E': 4, 'G': 8, 'I': 4, 'K': 8, 'L': 4, 'N': 4, 'O': 4, 'U': 8, 'V': 4, 'W': 4, 'X': 4}"
INV-ZZ-0000772,SCH-ZZ-0000184,1056,Boeing 787,08/22/2024,08/22/2024,LAX,MAA,270,304,141,-129,163,27,54,81,108,31,25,6,59,28,31,86,45,41,128,43,85,"{'F': 16, 'P': 11}","{'C': 22, 'J': 16, 'Z': 16}","{'Q': 24, 'R': 16, 'S': 8, 'T': 8, 'H': 16, 'M': 8}","{'Y': 8, 'A': 8, 'B': 4, 'D': 4, 'E': 4, 'G': 8, 'I': 4, 'K': 8, 'L': 4, 'N': 4, 'O': 4, 'U': 8, 'V': 4, 'W': 4, 'X': 4}"
INV-ZZ-0000645,SCH-ZZ-0000057,1057,Boeing 787,08/22/2024,08/22/2024,LAX,BLR,270,291,164,-106,127,27,54,81,108,31,19,12,56,32,24,84,45,39,120,68,52,"{'F': 16, 'P': 11}","{'C': 22, 'J': 16, 'Z': 16}","{'Q': 24, 'R': 16, 'S': 8, 'T': 8, 'H': 16, 'M': 8}","{'Y': 8, 'A': 8, 'B': 4, 'D': 4, 'E': 4, 'G': 8, 'I': 4, 'K': 8, 'L': 4, 'N': 4, 'O': 4, 'U': 8, 'V': 4, 'W': 4, 'X': 4}"
INV-ZZ-0000709,SCH-ZZ-0000121,1057,Boeing 787,08/22/2024,08/22/2024,LAX,BLR,270,294,177,-93,117,27,54,81,108,29,16,13,59,29,30,90,63,27,116,69,47,"{'F': 16, 'P': 11}","{'C': 22, 'J': 16, 'Z': 16}","{'Q': 24, 'R': 16, 'S': 8, 'T': 8, 'H': 16, 'M': 8}","{'Y': 8, 'A': 8, 'B': 4, 'D': 4, 'E': 4, 'G': 8, 'I': 4, 'K': 8, 'L': 4, 'N': 4, 'O': 4, 'U': 8, 'V': 4, 'W': 4, 'X': 4}"
INV-ZZ-0000773,SCH-ZZ-0000185,1057,Boeing 787,08/22/2024,08/22/2024,LAX,BLR,270,288,155,-115,133,27,54,81,108,29,25,4,56,27,29,82,56,26,121,47,74,"{'F': 16, 'P': 11}","{'C': 22, 'J': 16, 'Z': 16}","{'Q': 24, 'R': 16, 'S': 8, 'T': 8, 'H': 16, 'M': 8}","{'Y': 8, 'A': 8, 'B': 4, 'D': 4, 'E': 4, 'G': 8, 'I': 4, 'K': 8, 'L': 4, 'N': 4, 'O': 4, 'U': 8, 'V': 4, 'W': 4, 'X': 4}"
INV-ZZ-0000646,SCH-ZZ-0000058,1058,Boeing 787,08/22/2024,08/22/2024,LAX,BOM,270,300,157,-113,143,27,54,81,108,30,14,16,57,25,32,87,38,49,126,80,46,"{'F': 16, 'P': 11}","{'C': 22, 'J': 16, 'Z': 16}","{'Q': 24, 'R': 16, 'S': 8, 'T': 8, 'H': 16, 'M': 8}","{'Y': 8, 'A': 8, 'B': 4, 'D': 4, 'E': 4, 'G': 8, 'I': 4, 'K': 8, 'L': 4, 'N': 4, 'O': 4, 'U': 8, 'V': 4, 'W': 4, 'X': 4}"
INV-ZZ-0000710,SCH-ZZ-0000122,1058,Boeing 787,08/22/2024,08/22/2024,LAX,BOM,270,291,209,-61,82,27,54,81,108,32,19,13,55,51,4,88,37,51,116,102,14,"{'F': 16, 'P': 11}","{'C': 22, 'J': 16, 'Z': 16}","{'Q': 24, 'R': 16, 'S': 8, 'T': 8, 'H': 16, 'M': 8}","{'Y': 8, 'A': 8, 'B': 4, 'D': 4, 'E': 4, 'G': 8, 'I': 4, 'K': 8, 'L': 4, 'N': 4, 'O': 4, 'U': 8, 'V': 4, 'W': 4, 'X': 4}"
INV-ZZ-0000774,SCH-ZZ-0000186,1058,Boeing 787,08/22/2024,08/22/2024,LAX,BOM,270,297,213,-57,84,27,54,81,108,32,24,8,59,37,22,91,47,44,115,105,10,"{'F': 16, 'P': 11}","{'C': 22, 'J': 16, 'Z': 16}","{'Q': 24, 'R': 16, 'S': 8, 'T': 8, 'H': 16, 'M': 8}","{'Y': 8, 'A': 8, 'B': 4, 'D': 4, 'E': 4, 'G': 8, 'I': 4, 'K': 8, 'L': 4, 'N': 4, 'O': 4, 'U': 8, 'V': 4, 'W': 4, 'X': 4}"
INV-ZZ-0000647,SCH-ZZ-0000059,1059,Boeing 787,08/22/2024,08/22/2024,LAX,DUB,270,294,220,-50,74,27,54,81,108,29,11,18,58,35,23,85,66,19,122,108,14,"{'F': 16, 'P': 11}","{'C': 22, 'J': 16, 'Z': 16}","{'Q': 24, 'R': 16, 'S': 8, 'T': 8, 'H': 16, 'M': 8}","{'Y': 8, 'A': 8, 'B': 4, 'D': 4, 'E': 4, 'G': 8, 'I': 4, 'K': 8, 'L': 4, 'N': 4, 'O': 4, 'U': 8, 'V': 4, 'W': 4, 'X': 4}"
INV-ZZ-0000711,SCH-ZZ-0000123,1059,Boeing 787,08/22/2024,08/22/2024,LAX,DUB,270,299,167,-103,132,27,54,81,108,31,10,21,60,33,27,87,35,52,121,89,32,"{'F': 16, 'P': 11}","{'C': 22, 'J': 16, 'Z': 16}","{'Q': 24, 'R': 16, 'S': 8, 'T': 8, 'H': 16, 'M': 8}","{'Y': 8, 'A': 8, 'B': 4, 'D': 4, 'E': 4, 'G': 8, 'I': 4, 'K': 8, 'L': 4, 'N': 4, 'O': 4, 'U': 8, 'V': 4, 'W': 4, 'X': 4}"
INV-ZZ-0000775,SCH-ZZ-0000187,1059,Boeing 787,08/22/2024,08/22/2024,LAX,DUB,270,283,191,-79,92,27,54,81,108,30,20,10,55,31,24,88,39,49,110,101,9,"{'F': 16, 'P': 11}","{'C': 22, 'J': 16, 'Z': 16}","{'Q': 24, 'R': 16, 'S': 8, 'T': 8, 'H': 16, 'M': 8}","{'Y': 8, 'A': 8, 'B': 4, 'D': 4, 'E': 4, 'G': 8, 'I': 4, 'K': 8, 'L': 4, 'N': 4, 'O': 4, 'U': 8, 'V': 4, 'W': 4, 'X': 4}"
INV-ZZ-0000648,SCH-ZZ-0000060,1060,Boeing 787,08/22/2024,08/22/2024,LAX,VNS,270,299,200,-70,99,27,54,81,108,30,27,3,56,43,13,89,64,25,124,66,58,"{'F': 16, 'P': 11}","{'C': 22, 'J': 16, 'Z': 16}","{'Q': 24, 'R': 16, 'S': 8, 'T': 8, 'H': 16, 'M': 8}","{'Y': 8, 'A': 8, 'B': 4, 'D': 4, 'E': 4, 'G': 8, 'I': 4, 'K': 8, 'L': 4, 'N': 4, 'O': 4, 'U': 8, 'V': 4, 'W': 4, 'X': 4}"
INV-ZZ-0000712,SCH-ZZ-0000124,1060,Boeing 787,08/22/2024,08/22/2024,LAX,VNS,270,292,162,-108,130,27,54,81,108,28,17,11,61,27,34,85,52,33,118,66,52,"{'F': 16, 'P': 11}","{'C': 22, 'J': 16, 'Z': 16}","{'Q': 24, 'R': 16, 'S': 8, 'T': 8, 'H': 16, 'M': 8}","{'Y': 8, 'A': 8, 'B': 4, 'D': 4, 'E': 4, 'G': 8, 'I': 4, 'K': 8, 'L': 4, 'N': 4, 'O': 4, 'U': 8, 'V': 4, 'W': 4, 'X': 4}"
INV-ZZ-0000776,SCH-ZZ-0000188,1060,Boeing 787,08/22/2024,08/22/2024,LAX,VNS,270,295,194,-76,101,27,54,81,108,30,15,15,56,40,16,82,49,33,127,90,37,"{'F': 16, 'P': 11}","{'C': 22, 'J': 16, 'Z': 16}","{'Q': 24, 'R': 16, 'S': 8, 'T': 8, 'H': 16, 'M': 8}","{'Y': 8, 'A': 8, 'B': 4, 'D': 4, 'E': 4, 'G': 8, 'I': 4, 'K': 8, 'L': 4, 'N': 4, 'O': 4, 'U': 8, 'V': 4, 'W': 4, 'X': 4}"
INV-ZZ-0000649,SCH-ZZ-0000061,1061,Boeing 787,08/22/2024,08/22/2024,LAX,JFK,270,288,222,-48,66,27,54,81,108,32,27,5,60,42,18,87,47,40,109,106,3,"{'F': 16, 'P': 11}","{'C': 22, 'J': 16, 'Z': 16}","{'Q': 24, 'R': 16, 'S': 8, 'T': 8, 'H': 16, 'M': 8}","{'Y': 8, 'A': 8, 'B': 4, 'D': 4, 'E': 4, 'G': 8, 'I': 4, 'K': 8, 'L': 4, 'N': 4, 'O': 4, 'U': 8, 'V': 4, 'W': 4, 'X': 4}"
INV-ZZ-0000713,SCH-ZZ-0000125,1061,Boeing 787,08/22/2024,08/22/2024,LAX,JFK,270,297,215,-55,82,27,54,81,108,31,12,19,59,47,12,84,49,35,123,107,16,"{'F': 16, 'P': 11}","{'C': 22, 'J': 16, 'Z': 16}","{'Q': 24, 'R': 16, 'S': 8, 'T': 8, 'H': 16, 'M': 8}","{'Y': 8, 'A': 8, 'B': 4, 'D': 4, 'E': 4, 'G': 8, 'I': 4, 'K': 8, 'L': 4, 'N': 4, 'O': 4, 'U': 8, 'V': 4, 'W': 4, 'X': 4}"
INV-ZZ-0000777,SCH-ZZ-0000189,1061,Boeing 787,08/22/2024,08/22/2024,LAX,JFK,270,285,189,-81,96,27,54,81,108,30,27,3,61,20,41,85,52,33,109,90,19,"{'F': 16, 'P': 11}","{'C': 22, 'J': 16, 'Z': 16}","{'Q': 24, 'R': 16, 'S': 8, 'T': 8, 'H': 16, 'M': 8}","{'Y': 8, 'A': 8, 'B': 4, 'D': 4, 'E': 4, 'G': 8, 'I': 4, 'K': 8, 'L': 4, 'N': 4, 'O': 4, 'U': 8, 'V': 4, 'W': 4, 'X': 4}"
INV-ZZ-0000650,SCH-ZZ-0000062,1062,Boeing 787,08/22/2024,08/22/2024,LAX,DEL,270,295,220,-50,75,27,54,81,108,31,22,9,61,38,23,85,67,18,118,93,25,"{'F': 16, 'P': 11}","{'C': 22, 'J': 16, 'Z': 16}","{'Q': 24, 'R': 16, 'S': 8, 'T': 8, 'H': 16, 'M': 8}","{'Y': 8, 'A': 8, 'B': 4, 'D': 4, 'E': 4, 'G': 8, 'I': 4, 'K': 8, 'L': 4, 'N': 4, 'O': 4, 'U': 8, 'V': 4, 'W': 4, 'X': 4}"
INV-ZZ-0000714,SCH-ZZ-0000126,1062,Boeing 787,08/22/2024,08/22/2024,LAX,DEL,270,300,170,-100,130,27,54,81,108,28,11,17,57,32,25,90,46,44,125,81,44,"{'F': 16, 'P': 11}","{'C': 22, 'J': 16, 'Z': 16}","{'Q': 24, 'R': 16, 'S': 8, 'T': 8, 'H': 16, 'M': 8}","{'Y': 8, 'A': 8, 'B': 4, 'D': 4, 'E': 4, 'G': 8, 'I': 4, 'K': 8, 'L': 4, 'N': 4, 'O': 4, 'U': 8, 'V': 4, 'W': 4, 'X': 4}"
INV-ZZ-0000778,SCH-ZZ-0000190,1062,Boeing 787,08/22/2024,08/22/2024,LAX,DEL,270,280,159,-111,121,27,54,81,108,28,10,18,55,53,2,88,48,40,109,48,61,"{'F': 16, 'P': 11}","{'C': 22, 'J': 16, 'Z': 16}","{'Q': 24, 'R': 16, 'S': 8, 'T': 8, 'H': 16, 'M': 8}","{'Y': 8, 'A': 8, 'B': 4, 'D': 4, 'E': 4, 'G': 8, 'I': 4, 'K': 8, 'L': 4, 'N': 4, 'O': 4, 'U': 8, 'V': 4, 'W': 4, 'X': 4}"
INV-ZZ-0000785,SCH-ZZ-0000001,1001,Boeing 787,08/23/2024,08/23/2024,MAA,BLR,270,282,144,-126,138,27,54,81,108,32,19,13,55,20,35,83,58,25,112,47,65,"{'F': 16, 'P': 11}","{'C': 22, 'J': 16, 'Z': 16}","{'Q': 24, 'R': 16, 'S': 8, 'T': 8, 'H': 16, 'M': 8}","{'Y': 8, 'A': 8, 'B': 4, 'D': 4, 'E': 4, 'G': 8, 'I': 4, 'K': 8, 'L': 4, 'N': 4, 'O': 4, 'U': 8, 'V': 4, 'W': 4, 'X': 4}"
INV-ZZ-0000849,SCH-ZZ-0000065,1001,Boeing 787,08/23/2024,08/23/2024,MAA,BLR,270,300,178,-92,122,27,54,81,108,28,20,8,59,24,35,90,80,10,123,54,69,"{'F': 16, 'P': 11}","{'C': 22, 'J': 16, 'Z': 16}","{'Q': 24, 'R': 16, 'S': 8, 'T': 8, 'H': 16, 'M': 8}","{'Y': 8, 'A': 8, 'B': 4, 'D': 4, 'E': 4, 'G': 8, 'I': 4, 'K': 8, 'L': 4, 'N': 4, 'O': 4, 'U': 8, 'V': 4, 'W': 4, 'X': 4}"
INV-ZZ-0000913,SCH-ZZ-0000129,1001,Boeing 787,08/23/2024,08/23/2024,MAA,BLR,270,296,194,-76,102,27,54,81,108,30,19,11,57,26,31,89,45,44,120,104,16,"{'F': 16, 'P': 11}","{'C': 22, 'J': 16, 'Z': 16}","{'Q': 24, 'R': 16, 'S': 8, 'T': 8, 'H': 16, 'M': 8}","{'Y': 8, 'A': 8, 'B': 4, 'D': 4, 'E': 4, 'G': 8, 'I': 4, 'K': 8, 'L': 4, 'N': 4, 'O': 4, 'U': 8, 'V': 4, 'W': 4, 'X': 4}"
INV-ZZ-0000786,SCH-ZZ-0000002,1002,Boeing 787,08/23/2024,08/23/2024,MAA,BOM,270,300,229,-41,71,27,54,81,108,30,25,5,61,47,14,84,70,14,125,87,38,"{'F': 16, 'P': 11}","{'C': 22, 'J': 16, 'Z': 16}","{'Q': 24, 'R': 16, 'S': 8, 'T': 8, 'H': 16, 'M': 8}","{'Y': 8, 'A': 8, 'B': 4, 'D': 4, 'E': 4, 'G': 8, 'I': 4, 'K': 8, 'L': 4, 'N': 4, 'O': 4, 'U': 8, 'V': 4, 'W': 4, 'X': 4}"
INV-ZZ-0000850,SCH-ZZ-0000066,1002,Boeing 787,08/23/2024,08/23/2024,MAA,BOM,270,288,175,-95,113,27,54,81,108,32,18,14,55,20,35,89,43,46,112,94,18,"{'F': 16, 'P': 11}","{'C': 22, 'J': 16, 'Z': 16}","{'Q': 24, 'R': 16, 'S': 8, 'T': 8, 'H': 16, 'M': 8}","{'Y': 8, 'A': 8, 'B': 4, 'D': 4, 'E': 4, 'G': 8, 'I': 4, 'K': 8, 'L': 4, 'N': 4, 'O': 4, 'U': 8, 'V': 4, 'W': 4, 'X': 4}"
INV-ZZ-0000914,SCH-ZZ-0000130,1002,Boeing 787,08/23/2024,08/23/2024,MAA,BOM,270,287,218,-52,69,27,54,81,108,29,12,17,58,39,19,87,66,21,113,101,12,"{'F': 16, 'P': 11}","{'C': 22, 'J': 16, 'Z': 16}","{'Q': 24, 'R': 16, 'S': 8, 'T': 8, 'H': 16, 'M': 8}","{'Y': 8, 'A': 8, 'B': 4, 'D': 4, 'E': 4, 'G': 8, 'I': 4, 'K': 8, 'L': 4, 'N': 4, 'O': 4, 'U': 8, 'V': 4, 'W': 4, 'X': 4}"
INV-ZZ-0000787,SCH-ZZ-0000003,1003,Boeing 787,08/23/2024,08/23/2024,MAA,DUB,270,307,177,-93,130,27,54,81,108,30,25,5,58,22,36,91,53,38,128,77,51,"{'F': 16, 'P': 11}","{'C': 22, 'J': 16, 'Z': 16}","{'Q': 24, 'R': 16, 'S': 8, 'T': 8, 'H': 16, 'M': 8}","{'Y': 8, 'A': 8, 'B': 4, 'D': 4, 'E': 4, 'G': 8, 'I': 4, 'K': 8, 'L': 4, 'N': 4, 'O': 4, 'U': 8, 'V': 4, 'W': 4, 'X': 4}"
INV-ZZ-0000851,SCH-ZZ-0000067,1003,Boeing 787,08/23/2024,08/23/2024,MAA,DUB,270,290,212,-58,78,27,54,81,108,30,18,12,60,51,9,86,39,47,114,104,10,"{'F': 16, 'P': 11}","{'C': 22, 'J': 16, 'Z': 16}","{'Q': 24, 'R': 16, 'S': 8, 'T': 8, 'H': 16, 'M': 8}","{'Y': 8, 'A': 8, 'B': 4, 'D': 4, 'E': 4, 'G': 8, 'I': 4, 'K': 8, 'L': 4, 'N': 4, 'O': 4, 'U': 8, 'V': 4, 'W': 4, 'X': 4}"
INV-ZZ-0000915,SCH-ZZ-0000131,1003,Boeing 787,08/23/2024,08/23/2024,MAA,DUB,270,298,244,-26,54,27,54,81,108,28,20,8,60,52,8,88,68,20,122,104,18,"{'F': 16, 'P': 11}","{'C': 22, 'J': 16, 'Z': 16}","{'Q': 24, 'R': 16, 'S': 8, 'T': 8, 'H': 16, 'M': 8}","{'Y': 8, 'A': 8, 'B': 4, 'D': 4, 'E': 4, 'G': 8, 'I': 4, 'K': 8, 'L': 4, 'N': 4, 'O': 4, 'U': 8, 'V': 4, 'W': 4, 'X': 4}"
INV-ZZ-0000788,SCH-ZZ-0000004,1004,Boeing 787,08/23/2024,08/23/2024,MAA,VNS,270,304,208,-62,96,27,54,81,108,31,26,5,60,27,33,91,60,31,122,95,27,"{'F': 16, 'P': 11}","{'C': 22, 'J': 16, 'Z': 16}","{'Q': 24, 'R': 16, 'S': 8, 'T': 8, 'H': 16, 'M': 8}","{'Y': 8, 'A': 8, 'B': 4, 'D': 4, 'E': 4, 'G': 8, 'I': 4, 'K': 8, 'L': 4, 'N': 4, 'O': 4, 'U': 8, 'V': 4, 'W': 4, 'X': 4}"
INV-ZZ-0000852,SCH-ZZ-0000068,1004,Boeing 787,08/23/2024,08/23/2024,MAA,VNS,270,295,169,-101,126,27,54,81,108,28,22,6,61,51,10,83,55,28,123,41,82,"{'F': 16, 'P': 11}","{'C': 22, 'J': 16, 'Z': 16}","{'Q': 24, 'R': 16, 'S': 8, 'T': 8, 'H': 16, 'M': 8}","{'Y': 8, 'A': 8, 'B': 4, 'D': 4, 'E': 4, 'G': 8, 'I': 4, 'K': 8, 'L': 4, 'N': 4, 'O': 4, 'U': 8, 'V': 4, 'W': 4, 'X': 4}"
INV-ZZ-0000916,SCH-ZZ-0000132,1004,Boeing 787,08/23/2024,08/23/2024,MAA,VNS,270,292,209,-61,83,27,54,81,108,31,20,11,57,42,15,82,79,3,122,68,54,"{'F': 16, 'P': 11}","{'C': 22, 'J': 16, 'Z': 16}","{'Q': 24, 'R': 16, 'S': 8, 'T': 8, 'H': 16, 'M': 8}","{'Y': 8, 'A': 8, 'B': 4, 'D': 4, 'E': 4, 'G': 8, 'I': 4, 'K': 8, 'L': 4, 'N': 4, 'O': 4, 'U': 8, 'V': 4, 'W': 4, 'X': 4}"
INV-ZZ-0000789,SCH-ZZ-0000005,1005,Boeing 787,08/23/2024,08/23/2024,MAA,JFK,270,291,134,-136,157,27,54,81,108,28,17,11,58,24,34,90,41,49,115,52,63,"{'F': 16, 'P': 11}","{'C': 22, 'J': 16, 'Z': 16}","{'Q': 24, 'R': 16, 'S': 8, 'T': 8, 'H': 16, 'M': 8}","{'Y': 8, 'A': 8, 'B': 4, 'D': 4, 'E': 4, 'G': 8, 'I': 4, 'K': 8, 'L': 4, 'N': 4, 'O': 4, 'U': 8, 'V': 4, 'W': 4, 'X': 4}"
INV-ZZ-0000853,SCH-ZZ-0000069,1005,Boeing 787,08/23/2024,08/23/2024,MAA,JFK,270,285,206,-64,79,27,54,81,108,29,14,15,56,54,2,88,38,50,112,100,12,"{'F': 16, 'P': 11}","{'C': 22, 'J': 16, 'Z': 16}","{'Q': 24, 'R': 16, 'S': 8, 'T': 8, 'H': 16, 'M': 8}","{'Y': 8, 'A': 8, 'B': 4, 'D': 4, 'E': 4, 'G': 8, 'I': 4, 'K': 8, 'L': 4, 'N': 4, 'O': 4, 'U': 8, 'V': 4, 'W': 4, 'X': 4}"
INV-ZZ-0000917,SCH-ZZ-0000133,1005,Boeing 787,08/23/2024,08/23/2024,MAA,JFK,270,294,166,-104,128,27,54,81,108,32,25,7,57,35,22,90,50,40,115,56,59,"{'F': 16, 'P': 11}","{'C': 22, 'J': 16, 'Z': 16}","{'Q': 24, 'R': 16, 'S': 8, 'T': 8, 'H': 16, 'M': 8}","{'Y': 8, 'A': 8, 'B': 4, 'D': 4, 'E': 4, 'G': 8, 'I': 4, 'K': 8, 'L': 4, 'N': 4, 'O': 4, 'U': 8, 'V': 4, 'W': 4, 'X': 4}"
INV-ZZ-0000790,SCH-ZZ-0000006,1006,Boeing 787,08/23/2024,08/23/2024,MAA,DEL,270,290,169,-101,121,27,54,81,108,31,10,21,60,26,34,87,39,48,112,94,18,"{'F': 16, 'P': 11}","{'C': 22, 'J': 16, 'Z': 16}","{'Q': 24, 'R': 16, 'S': 8, 'T': 8, 'H': 16, 'M': 8}","{'Y': 8, 'A': 8, 'B': 4, 'D': 4, 'E': 4, 'G': 8, 'I': 4, 'K': 8, 'L': 4, 'N': 4, 'O': 4, 'U': 8, 'V': 4, 'W': 4, 'X': 4}"
INV-ZZ-0000854,SCH-ZZ-0000070,1006,Boeing 787,08/23/2024,08/23/2024,MAA,DEL,270,286,169,-101,117,27,54,81,108,30,17,13,55,48,7,83,49,34,118,55,63,"{'F': 16, 'P': 11}","{'C': 22, 'J': 16, 'Z': 16}","{'Q': 24, 'R': 16, 'S': 8, 'T': 8, 'H': 16, 'M': 8}","{'Y': 8, 'A': 8, 'B': 4, 'D': 4, 'E': 4, 'G': 8, 'I': 4, 'K': 8, 'L': 4, 'N': 4, 'O': 4, 'U': 8, 'V': 4, 'W': 4, 'X': 4}"
INV-ZZ-0000918,SCH-ZZ-0000134,1006,Boeing 787,08/23/2024,08/23/2024,MAA,DEL,270,293,181,-89,112,27,54,81,108,29,13,16,55,35,20,91,61,30,118,72,46,"{'F': 16, 'P': 11}","{'C': 22, 'J': 16, 'Z': 16}","{'Q': 24, 'R': 16, 'S': 8, 'T': 8, 'H': 16, 'M': 8}","{'Y': 8, 'A': 8, 'B': 4, 'D': 4, 'E': 4, 'G': 8, 'I': 4, 'K': 8, 'L': 4, 'N': 4, 'O': 4, 'U': 8, 'V': 4, 'W': 4, 'X': 4}"
INV-ZZ-0000791,SCH-ZZ-0000007,1007,Boeing 787,08/23/2024,08/23/2024,MAA,LAX,270,291,229,-41,62,27,54,81,108,28,12,16,58,54,4,83,66,17,122,97,25,"{'F': 16, 'P': 11}","{'C': 22, 'J': 16, 'Z': 16}","{'Q': 24, 'R': 16, 'S': 8, 'T': 8, 'H': 16, 'M': 8}","{'Y': 8, 'A': 8, 'B': 4, 'D': 4, 'E': 4, 'G': 8, 'I': 4, 'K': 8, 'L': 4, 'N': 4, 'O': 4, 'U': 8, 'V': 4, 'W': 4, 'X': 4}"
INV-ZZ-0000855,SCH-ZZ-0000071,1007,Boeing 787,08/23/2024,08/23/2024,MAA,LAX,270,286,190,-80,96,27,54,81,108,32,10,22,58,34,24,84,51,33,112,95,17,"{'F': 16, 'P': 11}","{'C': 22, 'J': 16, 'Z': 16}","{'Q': 24, 'R': 16, 'S': 8, 'T': 8, 'H': 16, 'M': 8}","{'Y': 8, 'A': 8, 'B': 4, 'D': 4, 'E': 4, 'G': 8, 'I': 4, 'K': 8, 'L': 4, 'N': 4, 'O': 4, 'U': 8, 'V': 4, 'W': 4, 'X': 4}"
INV-ZZ-0000919,SCH-ZZ-0000135,1007,Boeing 787,08/23/2024,08/23/2024,MAA,LAX,270,299,172,-98,127,27,54,81,108,28,11,17,60,24,36,88,66,22,123,71,52,"{'F': 16, 'P': 11}","{'C': 22, 'J': 16, 'Z': 16}","{'Q': 24, 'R': 16, 'S': 8, 'T': 8, 'H': 16, 'M': 8}","{'Y': 8, 'A': 8, 'B': 4, 'D': 4, 'E': 4, 'G': 8, 'I': 4, 'K': 8, 'L': 4, 'N': 4, 'O': 4, 'U': 8, 'V': 4, 'W': 4, 'X': 4}"
INV-ZZ-0000792,SCH-ZZ-0000008,1008,Boeing 787,08/23/2024,08/23/2024,BLR,MAA,270,290,163,-107,127,27,54,81,108,30,27,3,58,24,34,88,48,40,114,64,50,"{'F': 16, 'P': 11}","{'C': 22, 'J': 16, 'Z': 16}","{'Q': 24, 'R': 16, 'S': 8, 'T': 8, 'H': 16, 'M': 8}","{'Y': 8, 'A': 8, 'B': 4, 'D': 4, 'E': 4, 'G': 8, 'I': 4, 'K': 8, 'L': 4, 'N': 4, 'O': 4, 'U': 8, 'V': 4, 'W': 4, 'X': 4}"
INV-ZZ-0000856,SCH-ZZ-0000072,1008,Boeing 787,08/23/2024,08/23/2024,BLR,MAA,270,297,186,-84,111,27,54,81,108,32,12,20,55,48,7,86,43,43,124,83,41,"{'F': 16, 'P': 11}","{'C': 22, 'J': 16, 'Z': 16}","{'Q': 24, 'R': 16, 'S': 8, 'T': 8, 'H': 16, 'M': 8}","{'Y': 8, 'A': 8, 'B': 4, 'D': 4, 'E': 4, 'G': 8, 'I': 4, 'K': 8, 'L': 4, 'N': 4, 'O': 4, 'U': 8, 'V': 4, 'W': 4, 'X': 4}"
INV-ZZ-0000920,SCH-ZZ-0000136,1008,Boeing 787,08/23/2024,08/23/2024,BLR,MAA,270,289,213,-57,76,27,54,81,108,29,12,17,59,35,24,85,76,9,116,90,26,"{'F': 16, 'P': 11}","{'C': 22, 'J': 16, 'Z': 16}","{'Q': 24, 'R': 16, 'S': 8, 'T': 8, 'H': 16, 'M': 8}","{'Y': 8, 'A': 8, 'B': 4, 'D': 4, 'E': 4, 'G': 8, 'I': 4, 'K': 8, 'L': 4, 'N': 4, 'O': 4, 'U': 8, 'V': 4, 'W': 4, 'X': 4}"
INV-ZZ-0000794,SCH-ZZ-0000010,1010,Boeing 787,08/23/2024,08/23/2024,BLR,BOM,270,299,227,-43,72,27,54,81,108,30,20,10,56,23,33,87,80,7,126,104,22,"{'F': 16, 'P': 11}","{'C': 22, 'J': 16, 'Z': 16}","{'Q': 24, 'R': 16, 'S': 8, 'T': 8, 'H': 16, 'M': 8}","{'Y': 8, 'A': 8, 'B': 4, 'D': 4, 'E': 4, 'G': 8, 'I': 4, 'K': 8, 'L': 4, 'N': 4, 'O': 4, 'U': 8, 'V': 4, 'W': 4, 'X': 4}"
INV-ZZ-0000858,SCH-ZZ-0000074,1010,Boeing 787,08/23/2024,08/23/2024,BLR,BOM,270,301,193,-77,108,27,54,81,108,32,26,6,61,20,41,84,42,42,124,105,19,"{'F': 16, 'P': 11}","{'C': 22, 'J': 16, 'Z': 16}","{'Q': 24, 'R': 16, 'S': 8, 'T': 8, 'H': 16, 'M': 8}","{'Y': 8, 'A': 8, 'B': 4, 'D': 4, 'E': 4, 'G': 8, 'I': 4, 'K': 8, 'L': 4, 'N': 4, 'O': 4, 'U': 8, 'V': 4, 'W': 4, 'X': 4}"
INV-ZZ-0000922,SCH-ZZ-0000138,1010,Boeing 787,08/23/2024,08/23/2024,BLR,BOM,270,289,160,-110,129,27,54,81,108,29,26,3,61,23,38,89,51,38,110,60,50,"{'F': 16, 'P': 11}","{'C': 22, 'J': 16, 'Z': 16}","{'Q': 24, 'R': 16, 'S': 8, 'T': 8, 'H': 16, 'M': 8}","{'Y': 8, 'A': 8, 'B': 4, 'D': 4, 'E': 4, 'G': 8, 'I': 4, 'K': 8, 'L': 4, 'N': 4, 'O': 4, 'U': 8, 'V': 4, 'W': 4, 'X': 4}"
INV-ZZ-0000795,SCH-ZZ-0000011,1011,Boeing 787,08/23/2024,08/23/2024,BLR,DUB,270,299,156,-114,143,27,54,81,108,31,18,13,58,20,38,84,39,45,126,79,47,"{'F': 16, 'P': 11}","{'C': 22, 'J': 16, 'Z': 16}","{'Q': 24, 'R': 16, 'S': 8, 'T': 8, 'H': 16, 'M': 8}","{'Y': 8, 'A': 8, 'B': 4, 'D': 4, 'E': 4, 'G': 8, 'I': 4, 'K': 8, 'L': 4, 'N': 4, 'O': 4, 'U': 8, 'V': 4, 'W': 4, 'X': 4}"
INV-ZZ-0000859,SCH-ZZ-0000075,1011,Boeing 787,08/23/2024,08/23/2024,BLR,DUB,270,302,145,-125,157,27,54,81,108,31,10,21,55,34,21,88,54,34,128,47,81,"{'F': 16, 'P': 11}","{'C': 22, 'J': 16, 'Z': 16}","{'Q': 24, 'R': 16, 'S': 8, 'T': 8, 'H': 16, 'M': 8}","{'Y': 8, 'A': 8, 'B': 4, 'D': 4, 'E': 4, 'G': 8, 'I': 4, 'K': 8, 'L': 4, 'N': 4, 'O': 4, 'U': 8, 'V': 4, 'W': 4, 'X': 4}"
INV-ZZ-0000923,SCH-ZZ-0000139,1011,Boeing 787,08/23/2024,08/23/2024,BLR,DUB,270,296,169,-101,127,27,54,81,108,29,23,6,59,44,15,86,49,37,122,53,69,"{'F': 16, 'P': 11}","{'C': 22, 'J': 16, 'Z': 16}","{'Q': 24, 'R': 16, 'S': 8, 'T': 8, 'H': 16, 'M': 8}","{'Y': 8, 'A': 8, 'B': 4, 'D': 4, 'E': 4, 'G': 8, 'I': 4, 'K': 8, 'L': 4, 'N': 4, 'O': 4, 'U': 8, 'V': 4, 'W': 4, 'X': 4}"
INV-ZZ-0000796,SCH-ZZ-0000012,1012,Boeing 787,08/23/2024,08/23/2024,BLR,VNS,270,294,190,-80,104,27,54,81,108,28,12,16,59,49,10,91,51,40,116,78,38,"{'F': 16, 'P': 11}","{'C': 22, 'J': 16, 'Z': 16}","{'Q': 24, 'R': 16, 'S': 8, 'T': 8, 'H': 16, 'M': 8}","{'Y': 8, 'A': 8, 'B': 4, 'D': 4, 'E': 4, 'G': 8, 'I': 4, 'K': 8, 'L': 4, 'N': 4, 'O': 4, 'U': 8, 'V': 4, 'W': 4, 'X': 4}"
INV-ZZ-0000860,SCH-ZZ-0000076,1012,Boeing 787,08/23/2024,08/23/2024,BLR,VNS,270,288,181,-89,107,27,54,81,108,28,19,9,60,21,39,83,42,41,117,99,18,"{'F': 16, 'P': 11}","{'C': 22, 'J': 16, 'Z': 16}","{'Q': 24, 'R': 16, 'S': 8, 'T': 8, 'H': 16, 'M': 8}","{'Y': 8, 'A': 8, 'B': 4, 'D': 4, 'E': 4, 'G': 8, 'I': 4, 'K': 8, 'L': 4, 'N': 4, 'O': 4, 'U': 8, 'V': 4, 'W': 4, 'X': 4}"
INV-ZZ-0000924,SCH-ZZ-0000140,1012,Boeing 787,08/23/2024,08/23/2024,BLR,VNS,270,299,193,-77,106,27,54,81,108,30,23,7,61,54,7,82,40,42,126,76,50,"{'F': 16, 'P': 11}","{'C': 22, 'J': 16, 'Z': 16}","{'Q': 24, 'R': 16, 'S': 8, 'T': 8, 'H': 16, 'M': 8}","{'Y': 8, 'A': 8, 'B': 4, 'D': 4, 'E': 4, 'G': 8, 'I': 4, 'K': 8, 'L': 4, 'N': 4, 'O': 4, 'U': 8, 'V': 4, 'W': 4, 'X': 4}"
INV-ZZ-0000797,SCH-ZZ-0000013,1013,Boeing 787,08/23/2024,08/23/2024,BLR,JFK,270,283,208,-62,75,27,54,81,108,32,19,13,55,53,2,87,39,48,109,97,12,"{'F': 16, 'P': 11}","{'C': 22, 'J': 16, 'Z': 16}","{'Q': 24, 'R': 16, 'S': 8, 'T': 8, 'H': 16, 'M': 8}","{'Y': 8, 'A': 8, 'B': 4, 'D': 4, 'E': 4, 'G': 8, 'I': 4, 'K': 8, 'L': 4, 'N': 4, 'O': 4, 'U': 8, 'V': 4, 'W': 4, 'X': 4}"
INV-ZZ-0000861,SCH-ZZ-0000077,1013,Boeing 787,08/23/2024,08/23/2024,BLR,JFK,270,291,134,-136,157,27,54,81,108,32,25,7,59,25,34,89,41,48,111,43,68,"{'F': 16, 'P': 11}","{'C': 22, 'J': 16, 'Z': 16}","{'Q': 24, 'R': 16, 'S': 8, 'T': 8, 'H': 16, 'M': 8}","{'Y': 8, 'A': 8, 'B': 4, 'D': 4, 'E': 4, 'G': 8, 'I': 4, 'K': 8, 'L': 4, 'N': 4, 'O': 4, 'U': 8, 'V': 4, 'W': 4, 'X': 4}"
INV-ZZ-0000925,SCH-ZZ-0000141,1013,Boeing 787,08/23/2024,08/23/2024,BLR,JFK,270,288,168,-102,120,27,54,81,108,32,13,19,56,37,19,91,68,23,109,50,59,"{'F': 16, 'P': 11}","{'C': 22, 'J': 16, 'Z': 16}","{'Q': 24, 'R': 16, 'S': 8, 'T': 8, 'H': 16, 'M': 8}","{'Y': 8, 'A': 8, 'B': 4, 'D': 4, 'E': 4, 'G': 8, 'I': 4, 'K': 8, 'L': 4, 'N': 4, 'O': 4, 'U': 8, 'V': 4, 'W': 4, 'X': 4}"
INV-ZZ-0000798,SCH-ZZ-0000014,1014,Boeing 787,08/23/2024,08/23/2024,BLR,DEL,270,288,142,-128,146,27,54,81,108,28,16,12,60,25,35,84,56,28,116,45,71,"{'F': 16, 'P': 11}","{'C': 22, 'J': 16, 'Z': 16}","{'Q': 24, 'R': 16, 'S': 8, 'T': 8, 'H': 16, 'M': 8}","{'Y': 8, 'A': 8, 'B': 4, 'D': 4, 'E': 4, 'G': 8, 'I': 4, 'K': 8, 'L': 4, 'N': 4, 'O': 4, 'U': 8, 'V': 4, 'W': 4, 'X': 4}"
INV-ZZ-0000862,SCH-ZZ-0000078,1014,Boeing 787,08/23/2024,08/23/2024,BLR,DEL,270,298,132,-138,166,27,54,81,108,28,14,14,56,31,25,91,46,45,123,41,82,"{'F': 16, 'P': 11}","{'C': 22, 'J': 16, 'Z': 16}","{'Q': 24, 'R': 16, 'S': 8, 'T': 8, 'H': 16, 'M': 8}","{'Y': 8, 'A': 8, 'B': 4, 'D': 4, 'E': 4, 'G': 8, 'I': 4, 'K': 8, 'L': 4, 'N': 4, 'O': 4, 'U': 8, 'V': 4, 'W': 4, 'X': 4}"
INV-ZZ-0000926,SCH-ZZ-0000142,1014,Boeing 787,08/23/2024,08/23/2024,BLR,DEL,270,301,220,-50,81,27,54,81,108,28,23,5,59,47,12,91,68,23,123,82,41,"{'F': 16, 'P': 11}","{'C': 22, 'J': 16, 'Z': 16}","{'Q': 24, 'R': 16, 'S': 8, 'T': 8, 'H': 16, 'M': 8}","{'Y': 8, 'A': 8, 'B': 4, 'D': 4, 'E': 4, 'G': 8, 'I': 4, 'K': 8, 'L': 4, 'N': 4, 'O': 4, 'U': 8, 'V': 4, 'W': 4, 'X': 4}"
INV-ZZ-0000799,SCH-ZZ-0000015,1015,Boeing 787,08/23/2024,08/23/2024,BLR,LAX,270,295,183,-87,112,27,54,81,108,29,14,15,60,34,26,83,81,2,123,54,69,"{'F': 16, 'P': 11}","{'C': 22, 'J': 16, 'Z': 16}","{'Q': 24, 'R': 16, 'S': 8, 'T': 8, 'H': 16, 'M': 8}","{'Y': 8, 'A': 8, 'B': 4, 'D': 4, 'E': 4, 'G': 8, 'I': 4, 'K': 8, 'L': 4, 'N': 4, 'O': 4, 'U': 8, 'V': 4, 'W': 4, 'X': 4}"
INV-ZZ-0000863,SCH-ZZ-0000079,1015,Boeing 787,08/23/2024,08/23/2024,BLR,LAX,270,292,156,-114,136,27,54,81,108,32,11,21,57,38,19,90,44,46,113,63,50,"{'F': 16, 'P': 11}","{'C': 22, 'J': 16, 'Z': 16}","{'Q': 24, 'R': 16, 'S': 8, 'T': 8, 'H': 16, 'M': 8}","{'Y': 8, 'A': 8, 'B': 4, 'D': 4, 'E': 4, 'G': 8, 'I': 4, 'K': 8, 'L': 4, 'N': 4, 'O': 4, 'U': 8, 'V': 4, 'W': 4, 'X': 4}"
INV-ZZ-0000927,SCH-ZZ-0000143,1015,Boeing 787,08/23/2024,08/23/2024,BLR,LAX,270,300,154,-116,146,27,54,81,108,30,21,9,61,51,10,89,36,53,120,46,74,"{'F': 16, 'P': 11}","{'C': 22, 'J': 16, 'Z': 16}","{'Q': 24, 'R': 16, 'S': 8, 'T': 8, 'H': 16, 'M': 8}","{'Y': 8, 'A': 8, 'B': 4, 'D': 4, 'E': 4, 'G': 8, 'I': 4, 'K': 8, 'L': 4, 'N': 4, 'O': 4, 'U': 8, 'V': 4, 'W': 4, 'X': 4}"
INV-ZZ-0000800,SCH-ZZ-0000016,1016,Boeing 787,08/23/2024,08/23/2024,BOM,MAA,270,290,214,-56,76,27,54,81,108,28,18,10,59,27,32,91,63,28,112,106,6,"{'F': 16, 'P': 11}","{'C': 22, 'J': 16, 'Z': 16}","{'Q': 24, 'R': 16, 'S': 8, 'T': 8, 'H': 16, 'M': 8}","{'Y': 8, 'A': 8, 'B': 4, 'D': 4, 'E': 4, 'G': 8, 'I': 4, 'K': 8, 'L': 4, 'N': 4, 'O': 4, 'U': 8, 'V': 4, 'W': 4, 'X': 4}"
INV-ZZ-0000864,SCH-ZZ-0000080,1016,Boeing 787,08/23/2024,08/23/2024,BOM,MAA,270,294,168,-102,126,27,54,81,108,30,21,9,57,45,12,86,54,32,121,48,73,"{'F': 16, 'P': 11}","{'C': 22, 'J': 16, 'Z': 16}","{'Q': 24, 'R': 16, 'S': 8, 'T': 8, 'H': 16, 'M': 8}","{'Y': 8, 'A': 8, 'B': 4, 'D': 4, 'E': 4, 'G': 8, 'I': 4, 'K': 8, 'L': 4, 'N': 4, 'O': 4, 'U': 8, 'V': 4, 'W': 4, 'X': 4}"
INV-ZZ-0000928,SCH-ZZ-0000144,1016,Boeing 787,08/23/2024,08/23/2024,BOM,MAA,270,288,182,-88,106,27,54,81,108,32,12,20,57,36,21,85,58,27,114,76,38,"{'F': 16, 'P': 11}","{'C': 22, 'J': 16, 'Z': 16}","{'Q': 24, 'R': 16, 'S': 8, 'T': 8, 'H': 16, 'M': 8}","{'Y': 8, 'A': 8, 'B': 4, 'D': 4, 'E': 4, 'G': 8, 'I': 4, 'K': 8, 'L': 4, 'N': 4, 'O': 4, 'U': 8, 'V': 4, 'W': 4, 'X': 4}"
INV-ZZ-0000801,SCH-ZZ-0000017,1017,Boeing 787,08/23/2024,08/23/2024,BOM,BLR,270,283,194,-76,89,27,54,81,108,29,13,16,56,26,30,85,75,10,113,80,33,"{'F': 16, 'P': 11}","{'C': 22, 'J': 16, 'Z': 16}","{'Q': 24, 'R': 16, 'S': 8, 'T': 8, 'H': 16, 'M': 8}","{'Y': 8, 'A': 8, 'B': 4, 'D': 4, 'E': 4, 'G': 8, 'I': 4, 'K': 8, 'L': 4, 'N': 4, 'O': 4, 'U': 8, 'V': 4, 'W': 4, 'X': 4}"
INV-ZZ-0000865,SCH-ZZ-0000081,1017,Boeing 787,08/23/2024,08/23/2024,BOM,BLR,270,291,164,-106,127,27,54,81,108,32,18,14,58,30,28,90,74,16,111,42,69,"{'F': 16, 'P': 11}","{'C': 22, 'J': 16, 'Z': 16}","{'Q': 24, 'R': 16, 'S': 8, 'T': 8, 'H': 16, 'M': 8}","{'Y': 8, 'A': 8, 'B': 4, 'D': 4, 'E': 4, 'G': 8, 'I': 4, 'K': 8, 'L': 4, 'N': 4, 'O': 4, 'U': 8, 'V': 4, 'W': 4, 'X': 4}"
INV-ZZ-0000929,SCH-ZZ-0000145,1017,Boeing 787,08/23/2024,08/23/2024,BOM,BLR,270,292,204,-66,88,27,54,81,108,31,17,14,61,44,17,85,39,46,115,104,11,"{'F': 16, 'P': 11}","{'C': 22, 'J': 16, 'Z': 16}","{'Q': 24, 'R': 16, 'S': 8, 'T': 8, 'H': 16, 'M': 8}","{'Y': 8, 'A': 8, 'B': 4, 'D': 4, 'E': 4, 'G': 8, 'I': 4, 'K': 8, 'L': 4, 'N': 4, 'O': 4, 'U': 8, 'V': 4, 'W': 4, 'X': 4}"
INV-ZZ-0000803,SCH-ZZ-0000019,1019,Boeing 787,08/23/2024,08/23/2024,BOM,DUB,270,285,223,-47,62,27,54,81,108,29,21,8,57,42,15,88,65,23,111,95,16,"{'F': 16, 'P': 11}","{'C': 22, 'J': 16, 'Z': 16}","{'Q': 24, 'R': 16, 'S': 8, 'T': 8, 'H': 16, 'M': 8}","{'Y': 8, 'A': 8, 'B': 4, 'D': 4, 'E': 4, 'G': 8, 'I': 4, 'K': 8, 'L': 4, 'N': 4, 'O': 4, 'U': 8, 'V': 4, 'W': 4, 'X': 4}"
INV-ZZ-0000867,SCH-ZZ-0000083,1019,Boeing 787,08/23/2024,08/23/2024,BOM,DUB,270,286,216,-54,70,27,54,81,108,28,18,10,59,21,38,86,70,16,113,107,6,"{'F': 16, 'P': 11}","{'C': 22, 'J': 16, 'Z': 16}","{'Q': 24, 'R': 16, 'S': 8, 'T': 8, 'H': 16, 'M': 8}","{'Y': 8, 'A': 8, 'B': 4, 'D': 4, 'E': 4, 'G': 8, 'I': 4, 'K': 8, 'L': 4, 'N': 4, 'O': 4, 'U': 8, 'V': 4, 'W': 4, 'X': 4}"
INV-ZZ-0000931,SCH-ZZ-0000147,1019,Boeing 787,08/23/2024,08/23/2024,BOM,DUB,270,295,235,-35,60,27,54,81,108,28,15,13,58,38,20,88,78,10,121,104,17,"{'F': 16, 'P': 11}","{'C': 22, 'J': 16, 'Z': 16}","{'Q': 24, 'R': 16, 'S': 8, 'T': 8, 'H': 16, 'M': 8}","{'Y': 8, 'A': 8, 'B': 4, 'D': 4, 'E': 4, 'G': 8, 'I': 4, 'K': 8, 'L': 4, 'N': 4, 'O': 4, 'U': 8, 'V': 4, 'W': 4, 'X': 4}"
INV-ZZ-0000804,SCH-ZZ-0000020,1020,Boeing 787,08/23/2024,08/23/2024,BOM,VNS,270,293,201,-69,92,27,54,81,108,28,23,5,55,36,19,87,53,34,123,89,34,"{'F': 16, 'P': 11}","{'C': 22, 'J': 16, 'Z': 16}","{'Q': 24, 'R': 16, 'S': 8, 'T': 8, 'H': 16, 'M': 8}","{'Y': 8, 'A': 8, 'B': 4, 'D': 4, 'E': 4, 'G': 8, 'I': 4, 'K': 8, 'L': 4, 'N': 4, 'O': 4, 'U': 8, 'V': 4, 'W': 4, 'X': 4}"
INV-ZZ-0000868,SCH-ZZ-0000084,1020,Boeing 787,08/23/2024,08/23/2024,BOM,VNS,270,303,213,-57,90,27,54,81,108,32,14,18,58,38,20,91,55,36,122,106,16,"{'F': 16, 'P': 11}","{'C': 22, 'J': 16, 'Z': 16}","{'Q': 24, 'R': 16, 'S': 8, 'T': 8, 'H': 16, 'M': 8}","{'Y': 8, 'A': 8, 'B': 4, 'D': 4, 'E': 4, 'G': 8, 'I': 4, 'K': 8, 'L': 4, 'N': 4, 'O': 4, 'U': 8, 'V': 4, 'W': 4, 'X': 4}"
INV-ZZ-0000932,SCH-ZZ-0000148,1020,Boeing 787,08/23/2024,08/23/2024,BOM,VNS,270,293,182,-88,111,27,54,81,108,31,26,5,57,22,35,89,52,37,116,82,34,"{'F': 16, 'P': 11}","{'C': 22, 'J': 16, 'Z': 16}","{'Q': 24, 'R': 16, 'S': 8, 'T': 8, 'H': 16, 'M': 8}","{'Y': 8, 'A': 8, 'B': 4, 'D': 4, 'E': 4, 'G': 8, 'I': 4, 'K': 8, 'L': 4, 'N': 4, 'O': 4, 'U': 8, 'V': 4, 'W': 4, 'X': 4}"
INV-ZZ-0000805,SCH-ZZ-0000021,1021,Boeing 787,08/23/2024,08/23/2024,BOM,JFK,270,293,216,-54,77,27,54,81,108,28,21,7,56,44,12,87,72,15,122,79,43,"{'F': 16, 'P': 11}","{'C': 22, 'J': 16, 'Z': 16}","{'Q': 24, 'R': 16, 'S': 8, 'T': 8, 'H': 16, 'M': 8}","{'Y': 8, 'A': 8, 'B': 4, 'D': 4, 'E': 4, 'G': 8, 'I': 4, 'K': 8, 'L': 4, 'N': 4, 'O': 4, 'U': 8, 'V': 4, 'W': 4, 'X': 4}"
INV-ZZ-0000869,SCH-ZZ-0000085,1021,Boeing 787,08/23/2024,08/23/2024,BOM,JFK,270,290,187,-83,103,27,54,81,108,31,14,17,60,53,7,85,56,29,114,64,50,"{'F': 16, 'P': 11}","{'C': 22, 'J': 16, 'Z': 16}","{'Q': 24, 'R': 16, 'S': 8, 'T': 8, 'H': 16, 'M': 8}","{'Y': 8, 'A': 8, 'B': 4, 'D': 4, 'E': 4, 'G': 8, 'I': 4, 'K': 8, 'L': 4, 'N': 4, 'O': 4, 'U': 8, 'V': 4, 'W': 4, 'X': 4}"
INV-ZZ-0000933,SCH-ZZ-0000149,1021,Boeing 787,08/23/2024,08/23/2024,BOM,JFK,270,300,174,-96,126,27,54,81,108,28,23,5,56,42,14,88,48,40,128,61,67,"{'F': 16, 'P': 11}","{'C': 22, 'J': 16, 'Z': 16}","{'Q': 24, 'R': 16, 'S': 8, 'T': 8, 'H': 16, 'M': 8}","{'Y': 8, 'A': 8, 'B': 4, 'D': 4, 'E': 4, 'G': 8, 'I': 4, 'K': 8, 'L': 4, 'N': 4, 'O': 4, 'U': 8, 'V': 4, 'W': 4, 'X': 4}"
INV-ZZ-0000806,SCH-ZZ-0000022,1022,Boeing 787,08/23/2024,08/23/2024,BOM,DEL,270,292,142,-128,150,27,54,81,108,31,15,16,60,22,38,87,52,35,114,53,61,"{'F': 16, 'P': 11}","{'C': 22, 'J': 16, 'Z': 16}","{'Q': 24, 'R': 16, 'S': 8, 'T': 8, 'H': 16, 'M': 8}","{'Y': 8, 'A': 8, 'B': 4, 'D': 4, 'E': 4, 'G': 8, 'I': 4, 'K': 8, 'L': 4, 'N': 4, 'O': 4, 'U': 8, 'V': 4, 'W': 4, 'X': 4}"
INV-ZZ-0000870,SCH-ZZ-0000086,1022,Boeing 787,08/23/2024,08/23/2024,BOM,DEL,270,293,180,-90,113,27,54,81,108,31,27,4,60,41,19,90,36,54,112,76,36,"{'F': 16, 'P': 11}","{'C': 22, 'J': 16, 'Z': 16}","{'Q': 24, 'R': 16, 'S': 8, 'T': 8, 'H': 16, 'M': 8}","{'Y': 8, 'A': 8, 'B': 4, 'D': 4, 'E': 4, 'G': 8, 'I': 4, 'K': 8, 'L': 4, 'N': 4, 'O': 4, 'U': 8, 'V': 4, 'W': 4, 'X': 4}"
INV-ZZ-0000934,SCH-ZZ-0000150,1022,Boeing 787,08/23/2024,08/23/2024,BOM,DEL,270,296,177,-93,119,27,54,81,108,31,21,10,59,33,26,90,59,31,116,64,52,"{'F': 16, 'P': 11}","{'C': 22, 'J': 16, 'Z': 16}","{'Q': 24, 'R': 16, 'S': 8, 'T': 8, 'H': 16, 'M': 8}","{'Y': 8, 'A': 8, 'B': 4, 'D': 4, 'E': 4, 'G': 8, 'I': 4, 'K': 8, 'L': 4, 'N': 4, 'O': 4, 'U': 8, 'V': 4, 'W': 4, 'X': 4}"
INV-ZZ-0000807,SCH-ZZ-0000023,1023,Boeing 787,08/23/2024,08/23/2024,BOM,LAX,270,296,201,-69,95,27,54,81,108,32,10,22,60,47,13,84,43,41,120,101,19,"{'F': 16, 'P': 11}","{'C': 22, 'J': 16, 'Z': 16}","{'Q': 24, 'R': 16, 'S': 8, 'T': 8, 'H': 16, 'M': 8}","{'Y': 8, 'A': 8, 'B': 4, 'D': 4, 'E': 4, 'G': 8, 'I': 4, 'K': 8, 'L': 4, 'N': 4, 'O': 4, 'U': 8, 'V': 4, 'W': 4, 'X': 4}"
INV-ZZ-0000871,SCH-ZZ-0000087,1023,Boeing 787,08/23/2024,08/23/2024,BOM,LAX,270,287,195,-75,92,27,54,81,108,28,17,11,57,34,23,91,49,42,111,95,16,"{'F': 16, 'P': 11}","{'C': 22, 'J': 16, 'Z': 16}","{'Q': 24, 'R': 16, 'S': 8, 'T': 8, 'H': 16, 'M': 8}","{'Y': 8, 'A': 8, 'B': 4, 'D': 4, 'E': 4, 'G': 8, 'I': 4, 'K': 8, 'L': 4, 'N': 4, 'O': 4, 'U': 8, 'V': 4, 'W': 4, 'X': 4}"
INV-ZZ-0000935,SCH-ZZ-0000151,1023,Boeing 787,08/23/2024,08/23/2024,BOM,LAX,270,299,215,-55,84,27,54,81,108,31,13,18,60,53,7,86,68,18,122,81,41,"{'F': 16, 'P': 11}","{'C': 22, 'J': 16, 'Z': 16}","{'Q': 24, 'R': 16, 'S': 8, 'T': 8, 'H': 16, 'M': 8}","{'Y': 8, 'A': 8, 'B': 4, 'D': 4, 'E': 4, 'G': 8, 'I': 4, 'K': 8, 'L': 4, 'N': 4, 'O': 4, 'U': 8, 'V': 4, 'W': 4, 'X': 4}"
INV-ZZ-0000808,SCH-ZZ-0000024,1024,Boeing 787,08/23/2024,08/23/2024,DUB,MAA,270,300,228,-42,72,27,54,81,108,31,20,11,59,41,18,86,70,16,124,97,27,"{'F': 16, 'P': 11}","{'C': 22, 'J': 16, 'Z': 16}","{'Q': 24, 'R': 16, 'S': 8, 'T': 8, 'H': 16, 'M': 8}","{'Y': 8, 'A': 8, 'B': 4, 'D': 4, 'E': 4, 'G': 8, 'I': 4, 'K': 8, 'L': 4, 'N': 4, 'O': 4, 'U': 8, 'V': 4, 'W': 4, 'X': 4}"
INV-ZZ-0000872,SCH-ZZ-0000088,1024,Boeing 787,08/23/2024,08/23/2024,DUB,MAA,270,286,174,-96,112,27,54,81,108,32,27,5,59,22,37,85,78,7,110,47,63,"{'F': 16, 'P': 11}","{'C': 22, 'J': 16, 'Z': 16}","{'Q': 24, 'R': 16, 'S': 8, 'T': 8, 'H': 16, 'M': 8}","{'Y': 8, 'A': 8, 'B': 4, 'D': 4, 'E': 4, 'G': 8, 'I': 4, 'K': 8, 'L': 4, 'N': 4, 'O': 4, 'U': 8, 'V': 4, 'W': 4, 'X': 4}"
INV-ZZ-0000936,SCH-ZZ-0000152,1024,Boeing 787,08/23/2024,08/23/2024,DUB,MAA,270,291,175,-95,116,27,54,81,108,32,14,18,56,35,21,86,57,29,117,69,48,"{'F': 16, 'P': 11}","{'C': 22, 'J': 16, 'Z': 16}","{'Q': 24, 'R': 16, 'S': 8, 'T': 8, 'H': 16, 'M': 8}","{'Y': 8, 'A': 8, 'B': 4, 'D': 4, 'E': 4, 'G': 8, 'I': 4, 'K': 8, 'L': 4, 'N': 4, 'O': 4, 'U': 8, 'V': 4, 'W': 4, 'X': 4}"
INV-ZZ-0000809,SCH-ZZ-0000025,1025,Boeing 787,08/23/2024,08/23/2024,DUB,BLR,270,288,180,-90,108,27,54,81,108,30,11,19,56,44,12,86,44,42,116,81,35,"{'F': 16, 'P': 11}","{'C': 22, 'J': 16, 'Z': 16}","{'Q': 24, 'R': 16, 'S': 8, 'T': 8, 'H': 16, 'M': 8}","{'Y': 8, 'A': 8, 'B': 4, 'D': 4, 'E': 4, 'G': 8, 'I': 4, 'K': 8, 'L': 4, 'N': 4, 'O': 4, 'U': 8, 'V': 4, 'W': 4, 'X': 4}"
INV-ZZ-0000873,SCH-ZZ-0000089,1025,Boeing 787,08/23/2024,08/23/2024,DUB,BLR,270,294,174,-96,120,27,54,81,108,30,15,15,57,29,28,87,71,16,120,59,61,"{'F': 16, 'P': 11}","{'C': 22, 'J': 16, 'Z': 16}","{'Q': 24, 'R': 16, 'S': 8, 'T': 8, 'H': 16, 'M': 8}","{'Y': 8, 'A': 8, 'B': 4, 'D': 4, 'E': 4, 'G': 8, 'I': 4, 'K': 8, 'L': 4, 'N': 4, 'O': 4, 'U': 8, 'V': 4, 'W': 4, 'X': 4}"
INV-ZZ-0000937,SCH-ZZ-0000153,1025,Boeing 787,08/23/2024,08/23/2024,DUB,BLR,270,306,170,-100,136,27,54,81,108,30,16,14,60,28,32,91,52,39,125,74,51,"{'F': 16, 'P': 11}","{'C': 22, 'J': 16, 'Z': 16}","{'Q': 24, 'R': 16, 'S': 8, 'T': 8, 'H': 16, 'M': 8}","{'Y': 8, 'A': 8, 'B': 4, 'D': 4, 'E': 4, 'G': 8, 'I': 4, 'K': 8, 'L': 4, 'N': 4, 'O': 4, 'U': 8, 'V': 4, 'W': 4, 'X': 4}"
INV-ZZ-0000810,SCH-ZZ-0000026,1026,Boeing 787,08/23/2024,08/23/2024,DUB,BOM,270,276,143,-127,133,27,54,81,108,28,22,6,55,21,34,84,44,40,109,56,53,"{'F': 16, 'P': 11}","{'C': 22, 'J': 16, 'Z': 16}","{'Q': 24, 'R': 16, 'S': 8, 'T': 8, 'H': 16, 'M': 8}","{'Y': 8, 'A': 8, 'B': 4, 'D': 4, 'E': 4, 'G': 8, 'I': 4, 'K': 8, 'L': 4, 'N': 4, 'O': 4, 'U': 8, 'V': 4, 'W': 4, 'X': 4}"
INV-ZZ-0000874,SCH-ZZ-0000090,1026,Boeing 787,08/23/2024,08/23/2024,DUB,BOM,270,289,226,-44,63,27,54,81,108,30,21,9,59,46,13,91,53,38,109,106,3,"{'F': 16, 'P': 11}","{'C': 22, 'J': 16, 'Z': 16}","{'Q': 24, 'R': 16, 'S': 8, 'T': 8, 'H': 16, 'M': 8}","{'Y': 8, 'A': 8, 'B': 4, 'D': 4, 'E': 4, 'G': 8, 'I': 4, 'K': 8, 'L': 4, 'N': 4, 'O': 4, 'U': 8, 'V': 4, 'W': 4, 'X': 4}"
INV-ZZ-0000938,SCH-ZZ-0000154,1026,Boeing 787,08/23/2024,08/23/2024,DUB,BOM,270,296,146,-124,150,27,54,81,108,32,23,9,59,23,36,84,51,33,121,49,72,"{'F': 16, 'P': 11}","{'C': 22, 'J': 16, 'Z': 16}","{'Q': 24, 'R': 16, 'S': 8, 'T': 8, 'H': 16, 'M': 8}","{'Y': 8, 'A': 8, 'B': 4, 'D': 4, 'E': 4, 'G': 8, 'I': 4, 'K': 8, 'L': 4, 'N': 4, 'O': 4, 'U': 8, 'V': 4, 'W': 4, 'X': 4}"
INV-ZZ-0000812,SCH-ZZ-0000028,1028,Boeing 787,08/23/2024,08/23/2024,DUB,VNS,270,298,170,-100,128,27,54,81,108,31,26,5,60,36,24,86,68,18,121,40,81,"{'F': 16, 'P': 11}","{'C': 22, 'J': 16, 'Z': 16}","{'Q': 24, 'R': 16, 'S': 8, 'T': 8, 'H': 16, 'M': 8}","{'Y': 8, 'A': 8, 'B': 4, 'D': 4, 'E': 4, 'G': 8, 'I': 4, 'K': 8, 'L': 4, 'N': 4, 'O': 4, 'U': 8, 'V': 4, 'W': 4, 'X': 4}"
INV-ZZ-0000876,SCH-ZZ-0000092,1028,Boeing 787,08/23/2024,08/23/2024,DUB,VNS,270,296,216,-54,80,27,54,81,108,31,13,18,58,45,13,85,54,31,122,104,18,"{'F': 16, 'P': 11}","{'C': 22, 'J': 16, 'Z': 16}","{'Q': 24, 'R': 16, 'S': 8, 'T': 8, 'H': 16, 'M': 8}","{'Y': 8, 'A': 8, 'B': 4, 'D': 4, 'E': 4, 'G': 8, 'I': 4, 'K': 8, 'L': 4, 'N': 4, 'O': 4, 'U': 8, 'V': 4, 'W': 4, 'X': 4}"
INV-ZZ-0000940,SCH-ZZ-0000156,1028,Boeing 787,08/23/2024,08/23/2024,DUB,VNS,270,286,168,-102,118,27,54,81,108,30,20,10,58,51,7,87,43,44,111,54,57,"{'F': 16, 'P': 11}","{'C': 22, 'J': 16, 'Z': 16}","{'Q': 24, 'R': 16, 'S': 8, 'T': 8, 'H': 16, 'M': 8}","{'Y': 8, 'A': 8, 'B': 4, 'D': 4, 'E': 4, 'G': 8, 'I': 4, 'K': 8, 'L': 4, 'N': 4, 'O': 4, 'U': 8, 'V': 4, 'W': 4, 'X': 4}"
INV-ZZ-0000813,SCH-ZZ-0000029,1029,Boeing 787,08/23/2024,08/23/2024,DUB,JFK,270,291,217,-53,74,27,54,81,108,28,16,12,57,31,26,82,67,15,124,103,21,"{'F': 16, 'P': 11}","{'C': 22, 'J': 16, 'Z': 16}","{'Q': 24, 'R': 16, 'S': 8, 'T': 8, 'H': 16, 'M': 8}","{'Y': 8, 'A': 8, 'B': 4, 'D': 4, 'E': 4, 'G': 8, 'I': 4, 'K': 8, 'L': 4, 'N': 4, 'O': 4, 'U': 8, 'V': 4, 'W': 4, 'X': 4}"
INV-ZZ-0000877,SCH-ZZ-0000093,1029,Boeing 787,08/23/2024,08/23/2024,DUB,JFK,270,302,187,-83,115,27,54,81,108,30,15,15,61,45,16,84,48,36,127,79,48,"{'F': 16, 'P': 11}","{'C': 22, 'J': 16, 'Z': 16}","{'Q': 24, 'R': 16, 'S': 8, 'T': 8, 'H': 16, 'M': 8}","{'Y': 8, 'A': 8, 'B': 4, 'D': 4, 'E': 4, 'G': 8, 'I': 4, 'K': 8, 'L': 4, 'N': 4, 'O': 4, 'U': 8, 'V': 4, 'W': 4, 'X': 4}"
INV-ZZ-0000941,SCH-ZZ-0000157,1029,Boeing 787,08/23/2024,08/23/2024,DUB,JFK,270,287,185,-85,102,27,54,81,108,31,12,19,60,40,20,86,64,22,110,69,41,"{'F': 16, 'P': 11}","{'C': 22, 'J': 16, 'Z': 16}","{'Q': 24, 'R': 16, 'S': 8, 'T': 8, 'H': 16, 'M': 8}","{'Y': 8, 'A': 8, 'B': 4, 'D': 4, 'E': 4, 'G': 8, 'I': 4, 'K': 8, 'L': 4, 'N': 4, 'O': 4, 'U': 8, 'V': 4, 'W': 4, 'X': 4}"
INV-ZZ-0000814,SCH-ZZ-0000030,1030,Boeing 787,08/23/2024,08/23/2024,DUB,DEL,270,287,205,-65,82,27,54,81,108,31,26,5,56,31,25,90,68,22,110,80,30,"{'F': 16, 'P': 11}","{'C': 22, 'J': 16, 'Z': 16}","{'Q': 24, 'R': 16, 'S': 8, 'T': 8, 'H': 16, 'M': 8}","{'Y': 8, 'A': 8, 'B': 4, 'D': 4, 'E': 4, 'G': 8, 'I': 4, 'K': 8, 'L': 4, 'N': 4, 'O': 4, 'U': 8, 'V': 4, 'W': 4, 'X': 4}"
INV-ZZ-0000878,SCH-ZZ-0000094,1030,Boeing 787,08/23/2024,08/23/2024,DUB,DEL,270,300,172,-98,128,27,54,81,108,29,14,15,59,31,28,85,72,13,127,55,72,"{'F': 16, 'P': 11}","{'C': 22, 'J': 16, 'Z': 16}","{'Q': 24, 'R': 16, 'S': 8, 'T': 8, 'H': 16, 'M': 8}","{'Y': 8, 'A': 8, 'B': 4, 'D': 4, 'E': 4, 'G': 8, 'I': 4, 'K': 8, 'L': 4, 'N': 4, 'O': 4, 'U': 8, 'V': 4, 'W': 4, 'X': 4}"
INV-ZZ-0000942,SCH-ZZ-0000158,1030,Boeing 787,08/23/2024,08/23/2024,DUB,DEL,270,293,188,-82,105,27,54,81,108,28,12,16,56,47,9,91,55,36,118,74,44,"{'F': 16, 'P': 11}","{'C': 22, 'J': 16, 'Z': 16}","{'Q': 24, 'R': 16, 'S': 8, 'T': 8, 'H': 16, 'M': 8}","{'Y': 8, 'A': 8, 'B': 4, 'D': 4, 'E': 4, 'G': 8, 'I': 4, 'K': 8, 'L': 4, 'N': 4, 'O': 4, 'U': 8, 'V': 4, 'W': 4, 'X': 4}"
INV-ZZ-0000815,SCH-ZZ-0000031,1031,Boeing 787,08/23/2024,08/23/2024,DUB,LAX,270,307,218,-52,89,27,54,81,108,28,14,14,61,34,27,91,69,22,127,101,26,"{'F': 16, 'P': 11}","{'C': 22, 'J': 16, 'Z': 16}","{'Q': 24, 'R': 16, 'S': 8, 'T': 8, 'H': 16, 'M': 8}","{'Y': 8, 'A': 8, 'B': 4, 'D': 4, 'E': 4, 'G': 8, 'I': 4, 'K': 8, 'L': 4, 'N': 4, 'O': 4, 'U': 8, 'V': 4, 'W': 4, 'X': 4}"
INV-ZZ-0000879,SCH-ZZ-0000095,1031,Boeing 787,08/23/2024,08/23/2024,DUB,LAX,270,285,180,-90,105,27,54,81,108,28,12,16,57,45,12,89,56,33,111,67,44,"{'F': 16, 'P': 11}","{'C': 22, 'J': 16, 'Z': 16}","{'Q': 24, 'R': 16, 'S': 8, 'T': 8, 'H': 16, 'M': 8}","{'Y': 8, 'A': 8, 'B': 4, 'D': 4, 'E': 4, 'G': 8, 'I': 4, 'K': 8, 'L': 4, 'N': 4, 'O': 4, 'U': 8, 'V': 4, 'W': 4, 'X': 4}"
INV-ZZ-0000943,SCH-ZZ-0000159,1031,Boeing 787,08/23/2024,08/23/2024,DUB,LAX,270,297,213,-57,84,27,54,81,108,32,16,16,60,36,24,89,69,20,116,92,24,"{'F': 16, 'P': 11}","{'C': 22, 'J': 16, 'Z': 16}","{'Q': 24, 'R': 16, 'S': 8, 'T': 8, 'H': 16, 'M': 8}","{'Y': 8, 'A': 8, 'B': 4, 'D': 4, 'E': 4, 'G': 8, 'I': 4, 'K': 8, 'L': 4, 'N': 4, 'O': 4, 'U': 8, 'V': 4, 'W': 4, 'X': 4}"
INV-ZZ-0000816,SCH-ZZ-0000032,1032,Boeing 787,08/23/2024,08/23/2024,VNS,MAA,270,294,173,-97,121,27,54,81,108,28,16,12,56,34,22,91,53,38,119,70,49,"{'F': 16, 'P': 11}","{'C': 22, 'J': 16, 'Z': 16}","{'Q': 24, 'R': 16, 'S': 8, 'T': 8, 'H': 16, 'M': 8}","{'Y': 8, 'A': 8, 'B': 4, 'D': 4, 'E': 4, 'G': 8, 'I': 4, 'K': 8, 'L': 4, 'N': 4, 'O': 4, 'U': 8, 'V': 4, 'W': 4, 'X': 4}"
INV-ZZ-0000880,SCH-ZZ-0000096,1032,Boeing 787,08/23/2024,08/23/2024,VNS,MAA,270,301,155,-115,146,27,54,81,108,29,10,19,60,33,27,88,53,35,124,59,65,"{'F': 16, 'P': 11}","{'C': 22, 'J': 16, 'Z': 16}","{'Q': 24, 'R': 16, 'S': 8, 'T': 8, 'H': 16, 'M': 8}","{'Y': 8, 'A': 8, 'B': 4, 'D': 4, 'E': 4, 'G': 8, 'I': 4, 'K': 8, 'L': 4, 'N': 4, 'O': 4, 'U': 8, 'V': 4, 'W': 4, 'X': 4}"
INV-ZZ-0000944,SCH-ZZ-0000160,1032,Boeing 787,08/23/2024,08/23/2024,VNS,MAA,270,302,176,-94,126,27,54,81,108,31,16,15,56,24,32,87,67,20,128,69,59,"{'F': 16, 'P': 11}","{'C': 22, 'J': 16, 'Z': 16}","{'Q': 24, 'R': 16, 'S': 8, 'T': 8, 'H': 16, 'M': 8}","{'Y': 8, 'A': 8, 'B': 4, 'D': 4, 'E': 4, 'G': 8, 'I': 4, 'K': 8, 'L': 4, 'N': 4, 'O': 4, 'U': 8, 'V': 4, 'W': 4, 'X': 4}"
INV-ZZ-0000817,SCH-ZZ-0000033,1033,Boeing 787,08/23/2024,08/23/2024,VNS,BLR,270,281,165,-105,116,27,54,81,108,31,13,18,57,43,14,82,68,14,111,41,70,"{'F': 16, 'P': 11}","{'C': 22, 'J': 16, 'Z': 16}","{'Q': 24, 'R': 16, 'S': 8, 'T': 8, 'H': 16, 'M': 8}","{'Y': 8, 'A': 8, 'B': 4, 'D': 4, 'E': 4, 'G': 8, 'I': 4, 'K': 8, 'L': 4, 'N': 4, 'O': 4, 'U': 8, 'V': 4, 'W': 4, 'X': 4}"
INV-ZZ-0000881,SCH-ZZ-0000097,1033,Boeing 787,08/23/2024,08/23/2024,VNS,BLR,270,294,164,-106,130,27,54,81,108,29,15,14,55,52,3,85,45,40,125,52,73,"{'F': 16, 'P': 11}","{'C': 22, 'J': 16, 'Z': 16}","{'Q': 24, 'R': 16, 'S': 8, 'T': 8, 'H': 16, 'M': 8}","{'Y': 8, 'A': 8, 'B': 4, 'D': 4, 'E': 4, 'G': 8, 'I': 4, 'K': 8, 'L': 4, 'N': 4, 'O': 4, 'U': 8, 'V': 4, 'W': 4, 'X': 4}"
INV-ZZ-0000945,SCH-ZZ-0000161,1033,Boeing 787,08/23/2024,08/23/2024,VNS,BLR,270,297,192,-78,105,27,54,81,108,28,10,18,57,38,19,86,56,30,126,88,38,"{'F': 16, 'P': 11}","{'C': 22, 'J': 16, 'Z': 16}","{'Q': 24, 'R': 16, 'S': 8, 'T': 8, 'H': 16, 'M': 8}","{'Y': 8, 'A': 8, 'B': 4, 'D': 4, 'E': 4, 'G': 8, 'I': 4, 'K': 8, 'L': 4, 'N': 4, 'O': 4, 'U': 8, 'V': 4, 'W': 4, 'X': 4}"
INV-ZZ-0000818,SCH-ZZ-0000034,1034,Boeing 787,08/23/2024,08/23/2024,VNS,BOM,270,285,196,-74,89,27,54,81,108,30,20,10,56,50,6,83,81,2,116,45,71,"{'F': 16, 'P': 11}","{'C': 22, 'J': 16, 'Z': 16}","{'Q': 24, 'R': 16, 'S': 8, 'T': 8, 'H': 16, 'M': 8}","{'Y': 8, 'A': 8, 'B': 4, 'D': 4, 'E': 4, 'G': 8, 'I': 4, 'K': 8, 'L': 4, 'N': 4, 'O': 4, 'U': 8, 'V': 4, 'W': 4, 'X': 4}"
INV-ZZ-0000882,SCH-ZZ-0000098,1034,Boeing 787,08/23/2024,08/23/2024,VNS,BOM,270,297,248,-22,49,27,54,81,108,32,24,8,56,51,5,82,75,7,127,98,29,"{'F': 16, 'P': 11}","{'C': 22, 'J': 16, 'Z': 16}","{'Q': 24, 'R': 16, 'S': 8, 'T': 8, 'H': 16, 'M': 8}","{'Y': 8, 'A': 8, 'B': 4, 'D': 4, 'E': 4, 'G': 8, 'I': 4, 'K': 8, 'L': 4, 'N': 4, 'O': 4, 'U': 8, 'V': 4, 'W': 4, 'X': 4}"
INV-ZZ-0000946,SCH-ZZ-0000162,1034,Boeing 787,08/23/2024,08/23/2024,VNS,BOM,270,293,204,-66,89,27,54,81,108,31,23,8,55,27,28,85,70,15,122,84,38,"{'F': 16, 'P': 11}","{'C': 22, 'J': 16, 'Z': 16}","{'Q': 24, 'R': 16, 'S': 8, 'T': 8, 'H': 16, 'M': 8}","{'Y': 8, 'A': 8, 'B': 4, 'D': 4, 'E': 4, 'G': 8, 'I': 4, 'K': 8, 'L': 4, 'N': 4, 'O': 4, 'U': 8, 'V': 4, 'W': 4, 'X': 4}"
INV-ZZ-0000819,SCH-ZZ-0000035,1035,Boeing 787,08/23/2024,08/23/2024,VNS,DUB,270,283,184,-86,99,27,54,81,108,32,17,15,56,30,26,86,51,35,109,86,23,"{'F': 16, 'P': 11}","{'C': 22, 'J': 16, 'Z': 16}","{'Q': 24, 'R': 16, 'S': 8, 'T': 8, 'H': 16, 'M': 8}","{'Y': 8, 'A': 8, 'B': 4, 'D': 4, 'E': 4, 'G': 8, 'I': 4, 'K': 8, 'L': 4, 'N': 4, 'O': 4, 'U': 8, 'V': 4, 'W': 4, 'X': 4}"
INV-ZZ-0000883,SCH-ZZ-0000099,1035,Boeing 787,08/23/2024,08/23/2024,VNS,DUB,270,295,205,-65,90,27,54,81,108,29,16,13,55,37,18,84,64,20,127,88,39,"{'F': 16, 'P': 11}","{'C': 22, 'J': 16, 'Z': 16}","{'Q': 24, 'R': 16, 'S': 8, 'T': 8, 'H': 16, 'M': 8}","{'Y': 8, 'A': 8, 'B': 4, 'D': 4, 'E': 4, 'G': 8, 'I': 4, 'K': 8, 'L': 4, 'N': 4, 'O': 4, 'U': 8, 'V': 4, 'W': 4, 'X': 4}"
INV-ZZ-0000947,SCH-ZZ-0000163,1035,Boeing 787,08/23/2024,08/23/2024,VNS,DUB,270,292,204,-66,88,27,54,81,108,28,20,8,57,35,22,82,64,18,125,85,40,"{'F': 16, 'P': 11}","{'C': 22, 'J': 16, 'Z': 16}","{'Q': 24, 'R': 16, 'S': 8, 'T': 8, 'H': 16, 'M': 8}","{'Y': 8, 'A': 8, 'B': 4, 'D': 4, 'E': 4, 'G': 8, 'I': 4, 'K': 8, 'L': 4, 'N': 4, 'O': 4, 'U': 8, 'V': 4, 'W': 4, 'X': 4}"
INV-ZZ-0000821,SCH-ZZ-0000037,1037,Boeing 787,08/23/2024,08/23/2024,VNS,JFK,270,291,245,-25,46,27,54,81,108,28,13,15,60,49,11,90,79,11,113,104,9,"{'F': 16, 'P': 11}","{'C': 22, 'J': 16, 'Z': 16}","{'Q': 24, 'R': 16, 'S': 8, 'T': 8, 'H': 16, 'M': 8}","{'Y': 8, 'A': 8, 'B': 4, 'D': 4, 'E': 4, 'G': 8, 'I': 4, 'K': 8, 'L': 4, 'N': 4, 'O': 4, 'U': 8, 'V': 4, 'W': 4, 'X': 4}"
INV-ZZ-0000885,SCH-ZZ-0000101,1037,Boeing 787,08/23/2024,08/23/2024,VNS,JFK,270,288,172,-98,116,27,54,81,108,29,11,18,56,26,30,89,75,14,114,60,54,"{'F': 16, 'P': 11}","{'C': 22, 'J': 16, 'Z': 16}","{'Q': 24, 'R': 16, 'S': 8, 'T': 8, 'H': 16, 'M': 8}","{'Y': 8, 'A': 8, 'B': 4, 'D': 4, 'E': 4, 'G': 8, 'I': 4, 'K': 8, 'L': 4, 'N': 4, 'O': 4, 'U': 8, 'V': 4, 'W': 4, 'X': 4}"
INV-ZZ-0000949,SCH-ZZ-0000165,1037,Boeing 787,08/23/2024,08/23/2024,VNS,JFK,270,305,194,-76,111,27,54,81,108,30,11,19,58,43,15,91,44,47,126,96,30,"{'F': 16, 'P': 11}","{'C': 22, 'J': 16, 'Z': 16}","{'Q': 24, 'R': 16, 'S': 8, 'T': 8, 'H': 16, 'M': 8}","{'Y': 8, 'A': 8, 'B': 4, 'D': 4, 'E': 4, 'G': 8, 'I': 4, 'K': 8, 'L': 4, 'N': 4, 'O': 4, 'U': 8, 'V': 4, 'W': 4, 'X': 4}"
INV-ZZ-0000822,SCH-ZZ-0000038,1038,Boeing 787,08/23/2024,08/23/2024,VNS,DEL,270,305,182,-88,123,27,54,81,108,29,18,11,60,53,7,89,35,54,127,76,51,"{'F': 16, 'P': 11}","{'C': 22, 'J': 16, 'Z': 16}","{'Q': 24, 'R': 16, 'S': 8, 'T': 8, 'H': 16, 'M': 8}","{'Y': 8, 'A': 8, 'B': 4, 'D': 4, 'E': 4, 'G': 8, 'I': 4, 'K': 8, 'L': 4, 'N': 4, 'O': 4, 'U': 8, 'V': 4, 'W': 4, 'X': 4}"
INV-ZZ-0000886,SCH-ZZ-0000102,1038,Boeing 787,08/23/2024,08/23/2024,VNS,DEL,270,302,174,-96,128,27,54,81,108,32,14,18,56,53,3,86,40,46,128,67,61,"{'F': 16, 'P': 11}","{'C': 22, 'J': 16, 'Z': 16}","{'Q': 24, 'R': 16, 'S': 8, 'T': 8, 'H': 16, 'M': 8}","{'Y': 8, 'A': 8, 'B': 4, 'D': 4, 'E': 4, 'G': 8, 'I': 4, 'K': 8, 'L': 4, 'N': 4, 'O': 4, 'U': 8, 'V': 4, 'W': 4, 'X': 4}"
INV-ZZ-0000950,SCH-ZZ-0000166,1038,Boeing 787,08/23/2024,08/23/2024,VNS,DEL,270,300,197,-73,103,27,54,81,108,30,17,13,59,46,13,89,60,29,122,74,48,"{'F': 16, 'P': 11}","{'C': 22, 'J': 16, 'Z': 16}","{'Q': 24, 'R': 16, 'S': 8, 'T': 8, 'H': 16, 'M': 8}","{'Y': 8, 'A': 8, 'B': 4, 'D': 4, 'E': 4, 'G': 8, 'I': 4, 'K': 8, 'L': 4, 'N': 4, 'O': 4, 'U': 8, 'V': 4, 'W': 4, 'X': 4}"
INV-ZZ-0000823,SCH-ZZ-0000039,1039,Boeing 787,08/23/2024,08/23/2024,VNS,LAX,270,292,143,-127,149,27,54,81,108,28,17,11,57,36,21,84,49,35,123,41,82,"{'F': 16, 'P': 11}","{'C': 22, 'J': 16, 'Z': 16}","{'Q': 24, 'R': 16, 'S': 8, 'T': 8, 'H': 16, 'M': 8}","{'Y': 8, 'A': 8, 'B': 4, 'D': 4, 'E': 4, 'G': 8, 'I': 4, 'K': 8, 'L': 4, 'N': 4, 'O': 4, 'U': 8, 'V': 4, 'W': 4, 'X': 4}"
INV-ZZ-0000887,SCH-ZZ-0000103,1039,Boeing 787,08/23/2024,08/23/2024,VNS,LAX,270,302,162,-108,140,27,54,81,108,29,17,12,61,30,31,84,54,30,128,61,67,"{'F': 16, 'P': 11}","{'C': 22, 'J': 16, 'Z': 16}","{'Q': 24, 'R': 16, 'S': 8, 'T': 8, 'H': 16, 'M': 8}","{'Y': 8, 'A': 8, 'B': 4, 'D': 4, 'E': 4, 'G': 8, 'I': 4, 'K': 8, 'L': 4, 'N': 4, 'O': 4, 'U': 8, 'V': 4, 'W': 4, 'X': 4}"
INV-ZZ-0000951,SCH-ZZ-0000167,1039,Boeing 787,08/23/2024,08/23/2024,VNS,LAX,270,288,178,-92,110,27,54,81,108,31,26,5,59,25,34,89,49,40,109,78,31,"{'F': 16, 'P': 11}","{'C': 22, 'J': 16, 'Z': 16}","{'Q': 24, 'R': 16, 'S': 8, 'T': 8, 'H': 16, 'M': 8}","{'Y': 8, 'A': 8, 'B': 4, 'D': 4, 'E': 4, 'G': 8, 'I': 4, 'K': 8, 'L': 4, 'N': 4, 'O': 4, 'U': 8, 'V': 4, 'W': 4, 'X': 4}"
INV-ZZ-0000824,SCH-ZZ-0000040,1040,Boeing 787,08/23/2024,08/23/2024,JFK,MAA,270,297,175,-95,122,27,54,81,108,31,17,14,59,29,30,87,41,46,120,88,32,"{'F': 16, 'P': 11}","{'C': 22, 'J': 16, 'Z': 16}","{'Q': 24, 'R': 16, 'S': 8, 'T': 8, 'H': 16, 'M': 8}","{'Y': 8, 'A': 8, 'B': 4, 'D': 4, 'E': 4, 'G': 8, 'I': 4, 'K': 8, 'L': 4, 'N': 4, 'O': 4, 'U': 8, 'V': 4, 'W': 4, 'X': 4}"
INV-ZZ-0000888,SCH-ZZ-0000104,1040,Boeing 787,08/23/2024,08/23/2024,JFK,MAA,270,286,173,-97,113,27,54,81,108,32,13,19,60,40,20,85,51,34,109,69,40,"{'F': 16, 'P': 11}","{'C': 22, 'J': 16, 'Z': 16}","{'Q': 24, 'R': 16, 'S': 8, 'T': 8, 'H': 16, 'M': 8}","{'Y': 8, 'A': 8, 'B': 4, 'D': 4, 'E': 4, 'G': 8, 'I': 4, 'K': 8, 'L': 4, 'N': 4, 'O': 4, 'U': 8, 'V': 4, 'W': 4, 'X': 4}"
INV-ZZ-0000952,SCH-ZZ-0000168,1040,Boeing 787,08/23/2024,08/23/2024,JFK,MAA,270,305,198,-72,107,27,54,81,108,29,24,5,61,42,19,91,54,37,124,78,46,"{'F': 16, 'P': 11}","{'C': 22, 'J': 16, 'Z': 16}","{'Q': 24, 'R': 16, 'S': 8, 'T': 8, 'H': 16, 'M': 8}","{'Y': 8, 'A': 8, 'B': 4, 'D': 4, 'E': 4, 'G': 8, 'I': 4, 'K': 8, 'L': 4, 'N': 4, 'O': 4, 'U': 8, 'V': 4, 'W': 4, 'X': 4}"
INV-ZZ-0000825,SCH-ZZ-0000041,1041,Boeing 787,08/23/2024,08/23/2024,JFK,BLR,270,294,182,-88,112,27,54,81,108,32,11,21,60,49,11,90,80,10,112,42,70,"{'F': 16, 'P': 11}","{'C': 22, 'J': 16, 'Z': 16}","{'Q': 24, 'R': 16, 'S': 8, 'T': 8, 'H': 16, 'M': 8}","{'Y': 8, 'A': 8, 'B': 4, 'D': 4, 'E': 4, 'G': 8, 'I': 4, 'K': 8, 'L': 4, 'N': 4, 'O': 4, 'U': 8, 'V': 4, 'W': 4, 'X': 4}"
INV-ZZ-0000889,SCH-ZZ-0000105,1041,Boeing 787,08/23/2024,08/23/2024,JFK,BLR,270,287,152,-118,135,27,54,81,108,28,10,18,61,27,34,87,35,52,111,80,31,"{'F': 16, 'P': 11}","{'C': 22, 'J': 16, 'Z': 16}","{'Q': 24, 'R': 16, 'S': 8, 'T': 8, 'H': 16, 'M': 8}","{'Y': 8, 'A': 8, 'B': 4, 'D': 4, 'E': 4, 'G': 8, 'I': 4, 'K': 8, 'L': 4, 'N': 4, 'O': 4, 'U': 8, 'V': 4, 'W': 4, 'X': 4}"
INV-ZZ-0000953,SCH-ZZ-0000169,1041,Boeing 787,08/23/2024,08/23/2024,JFK,BLR,270,300,198,-72,102,27,54,81,108,31,22,9,58,50,8,85,68,17,126,58,68,"{'F': 16, 'P': 11}","{'C': 22, 'J': 16, 'Z': 16}","{'Q': 24, 'R': 16, 'S': 8, 'T': 8, 'H': 16, 'M': 8}","{'Y': 8, 'A': 8, 'B': 4, 'D': 4, 'E': 4, 'G': 8, 'I': 4, 'K': 8, 'L': 4, 'N': 4, 'O': 4, 'U': 8, 'V': 4, 'W': 4, 'X': 4}"
INV-ZZ-0000826,SCH-ZZ-0000042,1042,Boeing 787,08/23/2024,08/23/2024,JFK,BOM,270,296,207,-63,89,27,54,81,108,32,27,5,59,28,31,88,76,12,117,76,41,"{'F': 16, 'P': 11}","{'C': 22, 'J': 16, 'Z': 16}","{'Q': 24, 'R': 16, 'S': 8, 'T': 8, 'H': 16, 'M': 8}","{'Y': 8, 'A': 8, 'B': 4, 'D': 4, 'E': 4, 'G': 8, 'I': 4, 'K': 8, 'L': 4, 'N': 4, 'O': 4, 'U': 8, 'V': 4, 'W': 4, 'X': 4}"
INV-ZZ-0000890,SCH-ZZ-0000106,1042,Boeing 787,08/23/2024,08/23/2024,JFK,BOM,270,285,164,-106,121,27,54,81,108,29,23,6,58,20,38,82,51,31,116,70,46,"{'F': 16, 'P': 11}","{'C': 22, 'J': 16, 'Z': 16}","{'Q': 24, 'R': 16, 'S': 8, 'T': 8, 'H': 16, 'M': 8}","{'Y': 8, 'A': 8, 'B': 4, 'D': 4, 'E': 4, 'G': 8, 'I': 4, 'K': 8, 'L': 4, 'N': 4, 'O': 4, 'U': 8, 'V': 4, 'W': 4, 'X': 4}"
INV-ZZ-0000954,SCH-ZZ-0000170,1042,Boeing 787,08/23/2024,08/23/2024,JFK,BOM,270,296,148,-122,148,27,54,81,108,31,26,5,61,31,30,91,38,53,113,53,60,"{'F': 16, 'P': 11}","{'C': 22, 'J': 16, 'Z': 16}","{'Q': 24, 'R': 16, 'S': 8, 'T': 8, 'H': 16, 'M': 8}","{'Y': 8, 'A': 8, 'B': 4, 'D': 4, 'E': 4, 'G': 8, 'I': 4, 'K': 8, 'L': 4, 'N': 4, 'O': 4, 'U': 8, 'V': 4, 'W': 4, 'X': 4}"
INV-ZZ-0000827,SCH-ZZ-0000043,1043,Boeing 787,08/23/2024,08/23/2024,JFK,DUB,270,299,210,-60,89,27,54,81,108,32,15,17,55,49,6,85,68,17,127,78,49,"{'F': 16, 'P': 11}","{'C': 22, 'J': 16, 'Z': 16}","{'Q': 24, 'R': 16, 'S': 8, 'T': 8, 'H': 16, 'M': 8}","{'Y': 8, 'A': 8, 'B': 4, 'D': 4, 'E': 4, 'G': 8, 'I': 4, 'K': 8, 'L': 4, 'N': 4, 'O': 4, 'U': 8, 'V': 4, 'W': 4, 'X': 4}"
INV-ZZ-0000891,SCH-ZZ-0000107,1043,Boeing 787,08/23/2024,08/23/2024,JFK,DUB,270,279,199,-71,80,27,54,81,108,31,16,15,55,34,21,84,43,41,109,106,3,"{'F': 16, 'P': 11}","{'C': 22, 'J': 16, 'Z': 16}","{'Q': 24, 'R': 16, 'S': 8, 'T': 8, 'H': 16, 'M': 8}","{'Y': 8, 'A': 8, 'B': 4, 'D': 4, 'E': 4, 'G': 8, 'I': 4, 'K': 8, 'L': 4, 'N': 4, 'O': 4, 'U': 8, 'V': 4, 'W': 4, 'X': 4}"
INV-ZZ-0000955,SCH-ZZ-0000171,1043,Boeing 787,08/23/2024,08/23/2024,JFK,DUB,270,293,160,-110,133,27,54,81,108,32,17,15,60,20,40,86,64,22,115,59,56,"{'F': 16, 'P': 11}","{'C': 22, 'J': 16, 'Z': 16}","{'Q': 24, 'R': 16, 'S': 8, 'T': 8, 'H': 16, 'M': 8}","{'Y': 8, 'A': 8, 'B': 4, 'D': 4, 'E': 4, 'G': 8, 'I': 4, 'K': 8, 'L': 4, 'N': 4, 'O': 4, 'U': 8, 'V': 4, 'W': 4, 'X': 4}"
INV-ZZ-0000828,SCH-ZZ-0000044,1044,Boeing 787,08/23/2024,08/23/2024,JFK,VNS,270,292,199,-71,93,27,54,81,108,30,21,9,58,39,19,88,71,17,116,68,48,"{'F': 16, 'P': 11}","{'C': 22, 'J': 16, 'Z': 16}","{'Q': 24, 'R': 16, 'S': 8, 'T': 8, 'H': 16, 'M': 8}","{'Y': 8, 'A': 8, 'B': 4, 'D': 4, 'E': 4, 'G': 8, 'I': 4, 'K': 8, 'L': 4, 'N': 4, 'O': 4, 'U': 8, 'V': 4, 'W': 4, 'X': 4}"
INV-ZZ-0000892,SCH-ZZ-0000108,1044,Boeing 787,08/23/2024,08/23/2024,JFK,VNS,270,300,196,-74,104,27,54,81,108,31,15,16,61,46,15,82,49,33,126,86,40,"{'F': 16, 'P': 11}","{'C': 22, 'J': 16, 'Z': 16}","{'Q': 24, 'R': 16, 'S': 8, 'T': 8, 'H': 16, 'M': 8}","{'Y': 8, 'A': 8, 'B': 4, 'D': 4, 'E': 4, 'G': 8, 'I': 4, 'K': 8, 'L': 4, 'N': 4, 'O': 4, 'U': 8, 'V': 4, 'W': 4, 'X': 4}"
INV-ZZ-0000956,SCH-ZZ-0000172,1044,Boeing 787,08/23/2024,08/23/2024,JFK,VNS,270,301,213,-57,88,27,54,81,108,29,23,6,61,48,13,85,62,23,126,80,46,"{'F': 16, 'P': 11}","{'C': 22, 'J': 16, 'Z': 16}","{'Q': 24, 'R': 16, 'S': 8, 'T': 8, 'H': 16, 'M': 8}","{'Y': 8, 'A': 8, 'B': 4, 'D': 4, 'E': 4, 'G': 8, 'I': 4, 'K': 8, 'L': 4, 'N': 4, 'O': 4, 'U': 8, 'V': 4, 'W': 4, 'X': 4}"
INV-ZZ-0000830,SCH-ZZ-0000046,1046,Boeing 787,08/23/2024,08/23/2024,JFK,DEL,270,286,201,-69,85,27,54,81,108,32,21,11,58,41,17,82,56,26,114,83,31,"{'F': 16, 'P': 11}","{'C': 22, 'J': 16, 'Z': 16}","{'Q': 24, 'R': 16, 'S': 8, 'T': 8, 'H': 16, 'M': 8}","{'Y': 8, 'A': 8, 'B': 4, 'D': 4, 'E': 4, 'G': 8, 'I': 4, 'K': 8, 'L': 4, 'N': 4, 'O': 4, 'U': 8, 'V': 4, 'W': 4, 'X': 4}"
INV-ZZ-0000894,SCH-ZZ-0000110,1046,Boeing 787,08/23/2024,08/23/2024,JFK,DEL,270,294,208,-62,86,27,54,81,108,29,27,2,56,50,6,82,67,15,127,64,63,"{'F': 16, 'P': 11}","{'C': 22, 'J': 16, 'Z': 16}","{'Q': 24, 'R': 16, 'S': 8, 'T': 8, 'H': 16, 'M': 8}","{'Y': 8, 'A': 8, 'B': 4, 'D': 4, 'E': 4, 'G': 8, 'I': 4, 'K': 8, 'L': 4, 'N': 4, 'O': 4, 'U': 8, 'V': 4, 'W': 4, 'X': 4}"
INV-ZZ-0000958,SCH-ZZ-0000174,1046,Boeing 787,08/23/2024,08/23/2024,JFK,DEL,270,300,246,-24,54,27,54,81,108,30,18,12,60,54,6,91,70,21,119,104,15,"{'F': 16, 'P': 11}","{'C': 22, 'J': 16, 'Z': 16}","{'Q': 24, 'R': 16, 'S': 8, 'T': 8, 'H': 16, 'M': 8}","{'Y': 8, 'A': 8, 'B': 4, 'D': 4, 'E': 4, 'G': 8, 'I': 4, 'K': 8, 'L': 4, 'N': 4, 'O': 4, 'U': 8, 'V': 4, 'W': 4, 'X': 4}"
INV-ZZ-0000831,SCH-ZZ-0000047,1047,Boeing 787,08/23/2024,08/23/2024,JFK,LAX,270,289,158,-112,131,27,54,81,108,31,14,17,55,45,10,91,53,38,112,46,66,"{'F': 16, 'P': 11}","{'C': 22, 'J': 16, 'Z': 16}","{'Q': 24, 'R': 16, 'S': 8, 'T': 8, 'H': 16, 'M': 8}","{'Y': 8, 'A': 8, 'B': 4, 'D': 4, 'E': 4, 'G': 8, 'I': 4, 'K': 8, 'L': 4, 'N': 4, 'O': 4, 'U': 8, 'V': 4, 'W': 4, 'X': 4}"
INV-ZZ-0000895,SCH-ZZ-0000111,1047,Boeing 787,08/23/2024,08/23/2024,JFK,LAX,270,296,175,-95,121,27,54,81,108,28,20,8,59,30,29,84,78,6,125,47,78,"{'F': 16, 'P': 11}","{'C': 22, 'J': 16, 'Z': 16}","{'Q': 24, 'R': 16, 'S': 8, 'T': 8, 'H': 16, 'M': 8}","{'Y': 8, 'A': 8, 'B': 4, 'D': 4, 'E': 4, 'G': 8, 'I': 4, 'K': 8, 'L': 4, 'N': 4, 'O': 4, 'U': 8, 'V': 4, 'W': 4, 'X': 4}"
INV-ZZ-0000959,SCH-ZZ-0000175,1047,Boeing 787,08/23/2024,08/23/2024,JFK,LAX,270,297,185,-85,112,27,54,81,108,31,20,11,56,28,28,86,40,46,124,97,27,"{'F': 16, 'P': 11}","{'C': 22, 'J': 16, 'Z': 16}","{'Q': 24, 'R': 16, 'S': 8, 'T': 8, 'H': 16, 'M': 8}","{'Y': 8, 'A': 8, 'B': 4, 'D': 4, 'E': 4, 'G': 8, 'I': 4, 'K': 8, 'L': 4, 'N': 4, 'O': 4, 'U': 8, 'V': 4, 'W': 4, 'X': 4}"
INV-ZZ-0000832,SCH-ZZ-0000048,1048,Boeing 787,08/23/2024,08/23/2024,DEL,MAA,270,292,221,-49,71,27,54,81,108,30,14,16,57,22,35,87,77,10,118,108,10,"{'F': 16, 'P': 11}","{'C': 22, 'J': 16, 'Z': 16}","{'Q': 24, 'R': 16, 'S': 8, 'T': 8, 'H': 16, 'M': 8}","{'Y': 8, 'A': 8, 'B': 4, 'D': 4, 'E': 4, 'G': 8, 'I': 4, 'K': 8, 'L': 4, 'N': 4, 'O': 4, 'U': 8, 'V': 4, 'W': 4, 'X': 4}"
INV-ZZ-0000896,SCH-ZZ-0000112,1048,Boeing 787,08/23/2024,08/23/2024,DEL,MAA,270,294,143,-127,151,27,54,81,108,29,14,15,59,25,34,87,60,27,119,44,75,"{'F': 16, 'P': 11}","{'C': 22, 'J': 16, 'Z': 16}","{'Q': 24, 'R': 16, 'S': 8, 'T': 8, 'H': 16, 'M': 8}","{'Y': 8, 'A': 8, 'B': 4, 'D': 4, 'E': 4, 'G': 8, 'I': 4, 'K': 8, 'L': 4, 'N': 4, 'O': 4, 'U': 8, 'V': 4, 'W': 4, 'X': 4}"
INV-ZZ-0000960,SCH-ZZ-0000176,1048,Boeing 787,08/23/2024,08/23/2024,DEL,MAA,270,302,181,-89,121,27,54,81,108,30,12,18,61,54,7,88,73,15,123,42,81,"{'F': 16, 'P': 11}","{'C': 22, 'J': 16, 'Z': 16}","{'Q': 24, 'R': 16, 'S': 8, 'T': 8, 'H': 16, 'M': 8}","{'Y': 8, 'A': 8, 'B': 4, 'D': 4, 'E': 4, 'G': 8, 'I': 4, 'K': 8, 'L': 4, 'N': 4, 'O': 4, 'U': 8, 'V': 4, 'W': 4, 'X': 4}"
INV-ZZ-0000833,SCH-ZZ-0000049,1049,Boeing 787,08/23/2024,08/23/2024,DEL,BLR,270,284,205,-65,79,27,54,81,108,32,27,5,56,23,33,84,76,8,112,79,33,"{'F': 16, 'P': 11}","{'C': 22, 'J': 16, 'Z': 16}","{'Q': 24, 'R': 16, 'S': 8, 'T': 8, 'H': 16, 'M': 8}","{'Y': 8, 'A': 8, 'B': 4, 'D': 4, 'E': 4, 'G': 8, 'I': 4, 'K': 8, 'L': 4, 'N': 4, 'O': 4, 'U': 8, 'V': 4, 'W': 4, 'X': 4}"
INV-ZZ-0000897,SCH-ZZ-0000113,1049,Boeing 787,08/23/2024,08/23/2024,DEL,BLR,270,298,208,-62,90,27,54,81,108,28,23,5,60,52,8,91,67,24,119,66,53,"{'F': 16, 'P': 11}","{'C': 22, 'J': 16, 'Z': 16}","{'Q': 24, 'R': 16, 'S': 8, 'T': 8, 'H': 16, 'M': 8}","{'Y': 8, 'A': 8, 'B': 4, 'D': 4, 'E': 4, 'G': 8, 'I': 4, 'K': 8, 'L': 4, 'N': 4, 'O': 4, 'U': 8, 'V': 4, 'W': 4, 'X': 4}"
INV-ZZ-0000961,SCH-ZZ-0000177,1049,Boeing 787,08/23/2024,08/23/2024,DEL,BLR,270,294,157,-113,137,27,54,81,108,29,23,6,59,37,22,89,35,54,117,62,55,"{'F': 16, 'P': 11}","{'C': 22, 'J': 16, 'Z': 16}","{'Q': 24, 'R': 16, 'S': 8, 'T': 8, 'H': 16, 'M': 8}","{'Y': 8, 'A': 8, 'B': 4, 'D': 4, 'E': 4, 'G': 8, 'I': 4, 'K': 8, 'L': 4, 'N': 4, 'O': 4, 'U': 8, 'V': 4, 'W': 4, 'X': 4}"
INV-ZZ-0000834,SCH-ZZ-0000050,1050,Boeing 787,08/23/2024,08/23/2024,DEL,BOM,270,296,200,-70,96,27,54,81,108,32,18,14,58,43,15,91,42,49,115,97,18,"{'F': 16, 'P': 11}","{'C': 22, 'J': 16, 'Z': 16}","{'Q': 24, 'R': 16, 'S': 8, 'T': 8, 'H': 16, 'M': 8}","{'Y': 8, 'A': 8, 'B': 4, 'D': 4, 'E': 4, 'G': 8, 'I': 4, 'K': 8, 'L': 4, 'N': 4, 'O': 4, 'U': 8, 'V': 4, 'W': 4, 'X': 4}"
INV-ZZ-0000898,SCH-ZZ-0000114,1050,Boeing 787,08/23/2024,08/23/2024,DEL,BOM,270,299,150,-120,149,27,54,81,108,30,13,17,60,20,40,87,48,39,122,69,53,"{'F': 16, 'P': 11}","{'C': 22, 'J': 16, 'Z': 16}","{'Q': 24, 'R': 16, 'S': 8, 'T': 8, 'H': 16, 'M': 8}","{'Y': 8, 'A': 8, 'B': 4, 'D': 4, 'E': 4, 'G': 8, 'I': 4, 'K': 8, 'L': 4, 'N': 4, 'O': 4, 'U': 8, 'V': 4, 'W': 4, 'X': 4}"
INV-ZZ-0000962,SCH-ZZ-0000178,1050,Boeing 787,08/23/2024,08/23/2024,DEL,BOM,270,293,172,-98,121,27,54,81,108,32,19,13,58,53,5,89,48,41,114,52,62,"{'F': 16, 'P': 11}","{'C': 22, 'J': 16, 'Z': 16}","{'Q': 24, 'R': 16, 'S': 8, 'T': 8, 'H': 16, 'M': 8}","{'Y': 8, 'A': 8, 'B': 4, 'D': 4, 'E': 4, 'G': 8, 'I': 4, 'K': 8, 'L': 4, 'N': 4, 'O': 4, 'U': 8, 'V': 4, 'W': 4, 'X': 4}"
INV-ZZ-0000835,SCH-ZZ-0000051,1051,Boeing 787,08/23/2024,08/23/2024,DEL,DUB,270,308,152,-118,156,27,54,81,108,28,23,5,61,51,10,91,36,55,128,42,86,"{'F': 16, 'P': 11}","{'C': 22, 'J': 16, 'Z': 16}","{'Q': 24, 'R': 16, 'S': 8, 'T': 8, 'H': 16, 'M': 8}","{'Y': 8, 'A': 8, 'B': 4, 'D': 4, 'E': 4, 'G': 8, 'I': 4, 'K': 8, 'L': 4, 'N': 4, 'O': 4, 'U': 8, 'V': 4, 'W': 4, 'X': 4}"
INV-ZZ-0000899,SCH-ZZ-0000115,1051,Boeing 787,08/23/2024,08/23/2024,DEL,DUB,270,295,216,-54,79,27,54,81,108,30,22,8,60,25,35,88,64,24,117,105,12,"{'F': 16, 'P': 11}","{'C': 22, 'J': 16, 'Z': 16}","{'Q': 24, 'R': 16, 'S': 8, 'T': 8, 'H': 16, 'M': 8}","{'Y': 8, 'A': 8, 'B': 4, 'D': 4, 'E': 4, 'G': 8, 'I': 4, 'K': 8, 'L': 4, 'N': 4, 'O': 4, 'U': 8, 'V': 4, 'W': 4, 'X': 4}"
INV-ZZ-0000963,SCH-ZZ-0000179,1051,Boeing 787,08/23/2024,08/23/2024,DEL,DUB,270,286,190,-80,96,27,54,81,108,29,13,16,55,21,34,82,61,21,120,95,25,"{'F': 16, 'P': 11}","{'C': 22, 'J': 16, 'Z': 16}","{'Q': 24, 'R': 16, 'S': 8, 'T': 8, 'H': 16, 'M': 8}","{'Y': 8, 'A': 8, 'B': 4, 'D': 4, 'E': 4, 'G': 8, 'I': 4, 'K': 8, 'L': 4, 'N': 4, 'O': 4, 'U': 8, 'V': 4, 'W': 4, 'X': 4}"
INV-ZZ-0000836,SCH-ZZ-0000052,1052,Boeing 787,08/23/2024,08/23/2024,DEL,VNS,270,300,227,-43,73,27,54,81,108,28,18,10,58,49,9,88,71,17,126,89,37,"{'F': 16, 'P': 11}","{'C': 22, 'J': 16, 'Z': 16}","{'Q': 24, 'R': 16, 'S': 8, 'T': 8, 'H': 16, 'M': 8}","{'Y': 8, 'A': 8, 'B': 4, 'D': 4, 'E': 4, 'G': 8, 'I': 4, 'K': 8, 'L': 4, 'N': 4, 'O': 4, 'U': 8, 'V': 4, 'W': 4, 'X': 4}"
INV-ZZ-0000900,SCH-ZZ-0000116,1052,Boeing 787,08/23/2024,08/23/2024,DEL,VNS,270,294,191,-79,103,27,54,81,108,29,23,6,60,54,6,86,40,46,119,74,45,"{'F': 16, 'P': 11}","{'C': 22, 'J': 16, 'Z': 16}","{'Q': 24, 'R': 16, 'S': 8, 'T': 8, 'H': 16, 'M': 8}","{'Y': 8, 'A': 8, 'B': 4, 'D': 4, 'E': 4, 'G': 8, 'I': 4, 'K': 8, 'L': 4, 'N': 4, 'O': 4, 'U': 8, 'V': 4, 'W': 4, 'X': 4}"
INV-ZZ-0000964,SCH-ZZ-0000180,1052,Boeing 787,08/23/2024,08/23/2024,DEL,VNS,270,302,194,-76,108,27,54,81,108,30,26,4,57,49,8,91,61,30,124,58,66,"{'F': 16, 'P': 11}","{'C': 22, 'J': 16, 'Z': 16}","{'Q': 24, 'R': 16, 'S': 8, 'T': 8, 'H': 16, 'M': 8}","{'Y': 8, 'A': 8, 'B': 4, 'D': 4, 'E': 4, 'G': 8, 'I': 4, 'K': 8, 'L': 4, 'N': 4, 'O': 4, 'U': 8, 'V': 4, 'W': 4, 'X': 4}"
INV-ZZ-0000837,SCH-ZZ-0000053,1053,Boeing 787,08/23/2024,08/23/2024,DEL,JFK,270,285,236,-34,49,27,54,81,108,30,22,8,59,42,17,85,69,16,111,103,8,"{'F': 16, 'P': 11}","{'C': 22, 'J': 16, 'Z': 16}","{'Q': 24, 'R': 16, 'S': 8, 'T': 8, 'H': 16, 'M': 8}","{'Y': 8, 'A': 8, 'B': 4, 'D': 4, 'E': 4, 'G': 8, 'I': 4, 'K': 8, 'L': 4, 'N': 4, 'O': 4, 'U': 8, 'V': 4, 'W': 4, 'X': 4}"
INV-ZZ-0000901,SCH-ZZ-0000117,1053,Boeing 787,08/23/2024,08/23/2024,DEL,JFK,270,295,206,-64,89,27,54,81,108,29,16,13,60,22,38,82,81,1,124,87,37,"{'F': 16, 'P': 11}","{'C': 22, 'J': 16, 'Z': 16}","{'Q': 24, 'R': 16, 'S': 8, 'T': 8, 'H': 16, 'M': 8}","{'Y': 8, 'A': 8, 'B': 4, 'D': 4, 'E': 4, 'G': 8, 'I': 4, 'K': 8, 'L': 4, 'N': 4, 'O': 4, 'U': 8, 'V': 4, 'W': 4, 'X': 4}"
INV-ZZ-0000965,SCH-ZZ-0000181,1053,Boeing 787,08/23/2024,08/23/2024,DEL,JFK,270,279,183,-87,96,27,54,81,108,30,14,16,57,24,33,83,70,13,109,75,34,"{'F': 16, 'P': 11}","{'C': 22, 'J': 16, 'Z': 16}","{'Q': 24, 'R': 16, 'S': 8, 'T': 8, 'H': 16, 'M': 8}","{'Y': 8, 'A': 8, 'B': 4, 'D': 4, 'E': 4, 'G': 8, 'I': 4, 'K': 8, 'L': 4, 'N': 4, 'O': 4, 'U': 8, 'V': 4, 'W': 4, 'X': 4}"
INV-ZZ-0000839,SCH-ZZ-0000055,1055,Boeing 787,08/23/2024,08/23/2024,DEL,LAX,270,285,211,-59,74,27,54,81,108,31,12,19,57,54,3,86,52,34,111,93,18,"{'F': 16, 'P': 11}","{'C': 22, 'J': 16, 'Z': 16}","{'Q': 24, 'R': 16, 'S': 8, 'T': 8, 'H': 16, 'M': 8}","{'Y': 8, 'A': 8, 'B': 4, 'D': 4, 'E': 4, 'G': 8, 'I': 4, 'K': 8, 'L': 4, 'N': 4, 'O': 4, 'U': 8, 'V': 4, 'W': 4, 'X': 4}"
INV-ZZ-0000903,SCH-ZZ-0000119,1055,Boeing 787,08/23/2024,08/23/2024,DEL,LAX,270,283,213,-57,70,27,54,81,108,32,10,22,56,53,3,83,81,2,112,69,43,"{'F': 16, 'P': 11}","{'C': 22, 'J': 16, 'Z': 16}","{'Q': 24, 'R': 16, 'S': 8, 'T': 8, 'H': 16, 'M': 8}","{'Y': 8, 'A': 8, 'B': 4, 'D': 4, 'E': 4, 'G': 8, 'I': 4, 'K': 8, 'L': 4, 'N': 4, 'O': 4, 'U': 8, 'V': 4, 'W': 4, 'X': 4}"
INV-ZZ-0000967,SCH-ZZ-0000183,1055,Boeing 787,08/23/2024,08/23/2024,DEL,LAX,270,302,192,-78,110,27,54,81,108,30,12,18,61,35,26,86,70,16,125,75,50,"{'F': 16, 'P': 11}","{'C': 22, 'J': 16, 'Z': 16}","{'Q': 24, 'R': 16, 'S': 8, 'T': 8, 'H': 16, 'M': 8}","{'Y': 8, 'A': 8, 'B': 4, 'D': 4, 'E': 4, 'G': 8, 'I': 4, 'K': 8, 'L': 4, 'N': 4, 'O': 4, 'U': 8, 'V': 4, 'W': 4, 'X': 4}"
INV-ZZ-0000840,SCH-ZZ-0000056,1056,Boeing 787,08/23/2024,08/23/2024,LAX,MAA,270,297,209,-61,88,27,54,81,108,32,21,11,60,52,8,87,35,52,118,101,17,"{'F': 16, 'P': 11}","{'C': 22, 'J': 16, 'Z': 16}","{'Q': 24, 'R': 16, 'S': 8, 'T': 8, 'H': 16, 'M': 8}","{'Y': 8, 'A': 8, 'B': 4, 'D': 4, 'E': 4, 'G': 8, 'I': 4, 'K': 8, 'L': 4, 'N': 4, 'O': 4, 'U': 8, 'V': 4, 'W': 4, 'X': 4}"
INV-ZZ-0000904,SCH-ZZ-0000120,1056,Boeing 787,08/23/2024,08/23/2024,LAX,MAA,270,281,183,-87,98,27,54,81,108,28,18,10,55,51,4,88,72,16,110,42,68,"{'F': 16, 'P': 11}","{'C': 22, 'J': 16, 'Z': 16}","{'Q': 24, 'R': 16, 'S': 8, 'T': 8, 'H': 16, 'M': 8}","{'Y': 8, 'A': 8, 'B': 4, 'D': 4, 'E': 4, 'G': 8, 'I': 4, 'K': 8, 'L': 4, 'N': 4, 'O': 4, 'U': 8, 'V': 4, 'W': 4, 'X': 4}"
INV-ZZ-0000968,SCH-ZZ-0000184,1056,Boeing 787,08/23/2024,08/23/2024,LAX,MAA,270,297,182,-88,115,27,54,81,108,30,14,16,57,34,23,91,37,54,119,97,22,"{'F': 16, 'P': 11}","{'C': 22, 'J': 16, 'Z': 16}","{'Q': 24, 'R': 16, 'S': 8, 'T': 8, 'H': 16, 'M': 8}","{'Y': 8, 'A': 8, 'B': 4, 'D': 4, 'E': 4, 'G': 8, 'I': 4, 'K': 8, 'L': 4, 'N': 4, 'O': 4, 'U': 8, 'V': 4, 'W': 4, 'X': 4}"
INV-ZZ-0000841,SCH-ZZ-0000057,1057,Boeing 787,08/23/2024,08/23/2024,LAX,BLR,270,302,198,-72,104,27,54,81,108,31,27,4,59,46,13,91,57,34,121,68,53,"{'F': 16, 'P': 11}","{'C': 22, 'J': 16, 'Z': 16}","{'Q': 24, 'R': 16, 'S': 8, 'T': 8, 'H': 16, 'M': 8}","{'Y': 8, 'A': 8, 'B': 4, 'D': 4, 'E': 4, 'G': 8, 'I': 4, 'K': 8, 'L': 4, 'N': 4, 'O': 4, 'U': 8, 'V': 4, 'W': 4, 'X': 4}"
INV-ZZ-0000905,SCH-ZZ-0000121,1057,Boeing 787,08/23/2024,08/23/2024,LAX,BLR,270,290,196,-74,94,27,54,81,108,30,19,11,58,40,18,88,78,10,114,59,55,"{'F': 16, 'P': 11}","{'C': 22, 'J': 16, 'Z': 16}","{'Q': 24, 'R': 16, 'S': 8, 'T': 8, 'H': 16, 'M': 8}","{'Y': 8, 'A': 8, 'B': 4, 'D': 4, 'E': 4, 'G': 8, 'I': 4, 'K': 8, 'L': 4, 'N': 4, 'O': 4, 'U': 8, 'V': 4, 'W': 4, 'X': 4}"
INV-ZZ-0000969,SCH-ZZ-0000185,1057,Boeing 787,08/23/2024,08/23/2024,LAX,BLR,270,303,169,-101,134,27,54,81,108,32,21,11,56,40,16,88,37,51,127,71,56,"{'F': 16, 'P': 11}","{'C': 22, 'J': 16, 'Z': 16}","{'Q': 24, 'R': 16, 'S': 8, 'T': 8, 'H': 16, 'M': 8}","{'Y': 8, 'A': 8, 'B': 4, 'D': 4, 'E': 4, 'G': 8, 'I': 4, 'K': 8, 'L': 4, 'N': 4, 'O': 4, 'U': 8, 'V': 4, 'W': 4, 'X': 4}"
INV-ZZ-0000842,SCH-ZZ-0000058,1058,Boeing 787,08/23/2024,08/23/2024,LAX,BOM,270,288,248,-22,40,27,54,81,108,30,24,6,57,47,10,85,73,12,116,104,12,"{'F': 16, 'P': 11}","{'C': 22, 'J': 16, 'Z': 16}","{'Q': 24, 'R': 16, 'S': 8, 'T': 8, 'H': 16, 'M': 8}","{'Y': 8, 'A': 8, 'B': 4, 'D': 4, 'E': 4, 'G': 8, 'I': 4, 'K': 8, 'L': 4, 'N': 4, 'O': 4, 'U': 8, 'V': 4, 'W': 4, 'X': 4}"
INV-ZZ-0000906,SCH-ZZ-0000122,1058,Boeing 787,08/23/2024,08/23/2024,LAX,BOM,270,309,175,-95,134,27,54,81,108,30,14,16,61,49,12,91,67,24,127,45,82,"{'F': 16, 'P': 11}","{'C': 22, 'J': 16, 'Z': 16}","{'Q': 24, 'R': 16, 'S': 8, 'T': 8, 'H': 16, 'M': 8}","{'Y': 8, 'A': 8, 'B': 4, 'D': 4, 'E': 4, 'G': 8, 'I': 4, 'K': 8, 'L': 4, 'N': 4, 'O': 4, 'U': 8, 'V': 4, 'W': 4, 'X': 4}"
INV-ZZ-0000970,SCH-ZZ-0000186,1058,Boeing 787,08/23/2024,08/23/2024,LAX,BOM,270,285,227,-43,58,27,54,81,108,31,23,8,59,29,30,84,71,13,111,104,7,"{'F': 16, 'P': 11}","{'C': 22, 'J': 16, 'Z': 16}","{'Q': 24, 'R': 16, 'S': 8, 'T': 8, 'H': 16, 'M': 8}","{'Y': 8, 'A': 8, 'B': 4, 'D': 4, 'E': 4, 'G': 8, 'I': 4, 'K': 8, 'L': 4, 'N': 4, 'O': 4, 'U': 8, 'V': 4, 'W': 4, 'X': 4}"
INV-ZZ-0000843,SCH-ZZ-0000059,1059,Boeing 787,08/23/2024,08/23/2024,LAX,DUB,270,288,203,-67,85,27,54,81,108,32,10,22,58,31,27,82,79,3,116,83,33,"{'F': 16, 'P': 11}","{'C': 22, 'J': 16, 'Z': 16}","{'Q': 24, 'R': 16, 'S': 8, 'T': 8, 'H': 16, 'M': 8}","{'Y': 8, 'A': 8, 'B': 4, 'D': 4, 'E': 4, 'G': 8, 'I': 4, 'K': 8, 'L': 4, 'N': 4, 'O': 4, 'U': 8, 'V': 4, 'W': 4, 'X': 4}"
INV-ZZ-0000907,SCH-ZZ-0000123,1059,Boeing 787,08/23/2024,08/23/2024,LAX,DUB,270,292,188,-82,104,27,54,81,108,30,19,11,59,41,18,86,53,33,117,75,42,"{'F': 16, 'P': 11}","{'C': 22, 'J': 16, 'Z': 16}","{'Q': 24, 'R': 16, 'S': 8, 'T': 8, 'H': 16, 'M': 8}","{'Y': 8, 'A': 8, 'B': 4, 'D': 4, 'E': 4, 'G': 8, 'I': 4, 'K': 8, 'L': 4, 'N': 4, 'O': 4, 'U': 8, 'V': 4, 'W': 4, 'X': 4}"
INV-ZZ-0000971,SCH-ZZ-0000187,1059,Boeing 787,08/23/2024,08/23/2024,LAX,DUB,270,291,193,-77,98,27,54,81,108,28,18,10,60,40,20,82,46,36,121,89,32,"{'F': 16, 'P': 11}","{'C': 22, 'J': 16, 'Z': 16}","{'Q': 24, 'R': 16, 'S': 8, 'T': 8, 'H': 16, 'M': 8}","{'Y': 8, 'A': 8, 'B': 4, 'D': 4, 'E': 4, 'G': 8, 'I': 4, 'K': 8, 'L': 4, 'N': 4, 'O': 4, 'U': 8, 'V': 4, 'W': 4, 'X': 4}"
INV-ZZ-0000844,SCH-ZZ-0000060,1060,Boeing 787,08/23/2024,08/23/2024,LAX,VNS,270,291,185,-85,106,27,54,81,108,28,24,4,58,26,32,84,46,38,121,89,32,"{'F': 16, 'P': 11}","{'C': 22, 'J': 16, 'Z': 16}","{'Q': 24, 'R': 16, 'S': 8, 'T': 8, 'H': 16, 'M': 8}","{'Y': 8, 'A': 8, 'B': 4, 'D': 4, 'E': 4, 'G': 8, 'I': 4, 'K': 8, 'L': 4, 'N': 4, 'O': 4, 'U': 8, 'V': 4, 'W': 4, 'X': 4}"
INV-ZZ-0000908,SCH-ZZ-0000124,1060,Boeing 787,08/23/2024,08/23/2024,LAX,VNS,270,296,184,-86,112,27,54,81,108,28,22,6,57,29,28,84,80,4,127,53,74,"{'F': 16, 'P': 11}","{'C': 22, 'J': 16, 'Z': 16}","{'Q': 24, 'R': 16, 'S': 8, 'T': 8, 'H': 16, 'M': 8}","{'Y': 8, 'A': 8, 'B': 4, 'D': 4, 'E': 4, 'G': 8, 'I': 4, 'K': 8, 'L': 4, 'N': 4, 'O': 4, 'U': 8, 'V': 4, 'W': 4, 'X': 4}"
INV-ZZ-0000972,SCH-ZZ-0000188,1060,Boeing 787,08/23/2024,08/23/2024,LAX,VNS,270,299,144,-126,155,27,54,81,108,30,22,8,59,24,35,86,35,51,124,63,61,"{'F': 16, 'P': 11}","{'C': 22, 'J': 16, 'Z': 16}","{'Q': 24, 'R': 16, 'S': 8, 'T': 8, 'H': 16, 'M': 8}","{'Y': 8, 'A': 8, 'B': 4, 'D': 4, 'E': 4, 'G': 8, 'I': 4, 'K': 8, 'L': 4, 'N': 4, 'O': 4, 'U': 8, 'V': 4, 'W': 4, 'X': 4}"
INV-ZZ-0000845,SCH-ZZ-0000061,1061,Boeing 787,08/23/2024,08/23/2024,LAX,JFK,270,302,207,-63,95,27,54,81,108,30,22,8,56,47,9,88,37,51,128,101,27,"{'F': 16, 'P': 11}","{'C': 22, 'J': 16, 'Z': 16}","{'Q': 24, 'R': 16, 'S': 8, 'T': 8, 'H': 16, 'M': 8}","{'Y': 8, 'A': 8, 'B': 4, 'D': 4, 'E': 4, 'G': 8, 'I': 4, 'K': 8, 'L': 4, 'N': 4, 'O': 4, 'U': 8, 'V': 4, 'W': 4, 'X': 4}"
INV-ZZ-0000909,SCH-ZZ-0000125,1061,Boeing 787,08/23/2024,08/23/2024,LAX,JFK,270,297,159,-111,138,27,54,81,108,31,14,17,59,24,35,84,38,46,123,83,40,"{'F': 16, 'P': 11}","{'C': 22, 'J': 16, 'Z': 16}","{'Q': 24, 'R': 16, 'S': 8, 'T': 8, 'H': 16, 'M': 8}","{'Y': 8, 'A': 8, 'B': 4, 'D': 4, 'E': 4, 'G': 8, 'I': 4, 'K': 8, 'L': 4, 'N': 4, 'O': 4, 'U': 8, 'V': 4, 'W': 4, 'X': 4}"
INV-ZZ-0000973,SCH-ZZ-0000189,1061,Boeing 787,08/23/2024,08/23/2024,LAX,JFK,270,291,202,-68,89,27,54,81,108,30,16,14,56,34,22,88,72,16,117,80,37,"{'F': 16, 'P': 11}","{'C': 22, 'J': 16, 'Z': 16}","{'Q': 24, 'R': 16, 'S': 8, 'T': 8, 'H': 16, 'M': 8}","{'Y': 8, 'A': 8, 'B': 4, 'D': 4, 'E': 4, 'G': 8, 'I': 4, 'K': 8, 'L': 4, 'N': 4, 'O': 4, 'U': 8, 'V': 4, 'W': 4, 'X': 4}"
INV-ZZ-0000846,SCH-ZZ-0000062,1062,Boeing 787,08/23/2024,08/23/2024,LAX,DEL,270,304,185,-85,119,27,54,81,108,30,20,10,61,40,21,86,67,19,127,58,69,"{'F': 16, 'P': 11}","{'C': 22, 'J': 16, 'Z': 16}","{'Q': 24, 'R': 16, 'S': 8, 'T': 8, 'H': 16, 'M': 8}","{'Y': 8, 'A': 8, 'B': 4, 'D': 4, 'E': 4, 'G': 8, 'I': 4, 'K': 8, 'L': 4, 'N': 4, 'O': 4, 'U': 8, 'V': 4, 'W': 4, 'X': 4}"
INV-ZZ-0000910,SCH-ZZ-0000126,1062,Boeing 787,08/23/2024,08/23/2024,LAX,DEL,270,289,170,-100,119,27,54,81,108,30,20,10,56,34,22,82,63,19,121,53,68,"{'F': 16, 'P': 11}","{'C': 22, 'J': 16, 'Z': 16}","{'Q': 24, 'R': 16, 'S': 8, 'T': 8, 'H': 16, 'M': 8}","{'Y': 8, 'A': 8, 'B': 4, 'D': 4, 'E': 4, 'G': 8, 'I': 4, 'K': 8, 'L': 4, 'N': 4, 'O': 4, 'U': 8, 'V': 4, 'W': 4, 'X': 4}"
INV-ZZ-0000974,SCH-ZZ-0000190,1062,Boeing 787,08/23/2024,08/23/2024,LAX,DEL,270,296,198,-72,98,27,54,81,108,30,13,17,55,21,34,90,69,21,121,95,26,"{'F': 16, 'P': 11}","{'C': 22, 'J': 16, 'Z': 16}","{'Q': 24, 'R': 16, 'S': 8, 'T': 8, 'H': 16, 'M': 8}","{'Y': 8, 'A': 8, 'B': 4, 'D': 4, 'E': 4, 'G': 8, 'I': 4, 'K': 8, 'L': 4, 'N': 4, 'O': 4, 'U': 8, 'V': 4, 'W': 4, 'X': 4}"
INV-ZZ-0000981,SCH-ZZ-0000001,1001,Boeing 787,08/24/2024,08/24/2024,MAA,BLR,270,283,176,-94,107,27,54,81,108,32,10,22,56,54,2,86,37,49,109,75,34,"{'F': 16, 'P': 11}","{'C': 22, 'J': 16, 'Z': 16}","{'Q': 24, 'R': 16, 'S': 8, 'T': 8, 'H': 16, 'M': 8}","{'Y': 8, 'A': 8, 'B': 4, 'D': 4, 'E': 4, 'G': 8, 'I': 4, 'K': 8, 'L': 4, 'N': 4, 'O': 4, 'U': 8, 'V': 4, 'W': 4, 'X': 4}"
INV-ZZ-0001045,SCH-ZZ-0000065,1001,Boeing 787,08/24/2024,08/24/2024,MAA,BLR,270,290,178,-92,112,27,54,81,108,32,17,15,56,41,15,82,39,43,120,81,39,"{'F': 16, 'P': 11}","{'C': 22, 'J': 16, 'Z': 16}","{'Q': 24, 'R': 16, 'S': 8, 'T': 8, 'H': 16, 'M': 8}","{'Y': 8, 'A': 8, 'B': 4, 'D': 4, 'E': 4, 'G': 8, 'I': 4, 'K': 8, 'L': 4, 'N': 4, 'O': 4, 'U': 8, 'V': 4, 'W': 4, 'X': 4}"
INV-ZZ-0001109,SCH-ZZ-0000129,1001,Boeing 787,08/24/2024,08/24/2024,MAA,BLR,270,293,153,-117,140,27,54,81,108,32,23,9,56,35,21,91,44,47,114,51,63,"{'F': 16, 'P': 11}","{'C': 22, 'J': 16, 'Z': 16}","{'Q': 24, 'R': 16, 'S': 8, 'T': 8, 'H': 16, 'M': 8}","{'Y': 8, 'A': 8, 'B': 4, 'D': 4, 'E': 4, 'G': 8, 'I': 4, 'K': 8, 'L': 4, 'N': 4, 'O': 4, 'U': 8, 'V': 4, 'W': 4, 'X': 4}"
INV-ZZ-0000982,SCH-ZZ-0000002,1002,Boeing 787,08/24/2024,08/24/2024,MAA,BOM,270,288,200,-70,88,27,54,81,108,28,17,11,55,44,11,88,50,38,117,89,28,"{'F': 16, 'P': 11}","{'C': 22, 'J': 16, 'Z': 16}","{'Q': 24, 'R': 16, 'S': 8, 'T': 8, 'H': 16, 'M': 8}","{'Y': 8, 'A': 8, 'B': 4, 'D': 4, 'E': 4, 'G': 8, 'I': 4, 'K': 8, 'L': 4, 'N': 4, 'O': 4, 'U': 8, 'V': 4, 'W': 4, 'X': 4}"
INV-ZZ-0001046,SCH-ZZ-0000066,1002,Boeing 787,08/24/2024,08/24/2024,MAA,BOM,270,291,198,-72,93,27,54,81,108,29,27,2,58,23,35,82,58,24,122,90,32,"{'F': 16, 'P': 11}","{'C': 22, 'J': 16, 'Z': 16}","{'Q': 24, 'R': 16, 'S': 8, 'T': 8, 'H': 16, 'M': 8}","{'Y': 8, 'A': 8, 'B': 4, 'D': 4, 'E': 4, 'G': 8, 'I': 4, 'K': 8, 'L': 4, 'N': 4, 'O': 4, 'U': 8, 'V': 4, 'W': 4, 'X': 4}"
INV-ZZ-0001110,SCH-ZZ-0000130,1002,Boeing 787,08/24/2024,08/24/2024,MAA,BOM,270,291,181,-89,110,27,54,81,108,29,25,4,55,41,14,82,65,17,125,50,75,"{'F': 16, 'P': 11}","{'C': 22, 'J': 16, 'Z': 16}","{'Q': 24, 'R': 16, 'S': 8, 'T': 8, 'H': 16, 'M': 8}","{'Y': 8, 'A': 8, 'B': 4, 'D': 4, 'E': 4, 'G': 8, 'I': 4, 'K': 8, 'L': 4, 'N': 4, 'O': 4, 'U': 8, 'V': 4, 'W': 4, 'X': 4}"
INV-ZZ-0000983,SCH-ZZ-0000003,1003,Boeing 787,08/24/2024,08/24/2024,MAA,DUB,270,288,182,-88,106,27,54,81,108,32,18,14,59,50,9,86,38,48,111,76,35,"{'F': 16, 'P': 11}","{'C': 22, 'J': 16, 'Z': 16}","{'Q': 24, 'R': 16, 'S': 8, 'T': 8, 'H': 16, 'M': 8}","{'Y': 8, 'A': 8, 'B': 4, 'D': 4, 'E': 4, 'G': 8, 'I': 4, 'K': 8, 'L': 4, 'N': 4, 'O': 4, 'U': 8, 'V': 4, 'W': 4, 'X': 4}"
INV-ZZ-0001047,SCH-ZZ-0000067,1003,Boeing 787,08/24/2024,08/24/2024,MAA,DUB,270,296,206,-64,90,27,54,81,108,32,14,18,58,43,15,87,52,35,119,97,22,"{'F': 16, 'P': 11}","{'C': 22, 'J': 16, 'Z': 16}","{'Q': 24, 'R': 16, 'S': 8, 'T': 8, 'H': 16, 'M': 8}","{'Y': 8, 'A': 8, 'B': 4, 'D': 4, 'E': 4, 'G': 8, 'I': 4, 'K': 8, 'L': 4, 'N': 4, 'O': 4, 'U': 8, 'V': 4, 'W': 4, 'X': 4}"
INV-ZZ-0001111,SCH-ZZ-0000131,1003,Boeing 787,08/24/2024,08/24/2024,MAA,DUB,270,287,124,-146,163,27,54,81,108,31,19,12,61,24,37,85,36,49,110,45,65,"{'F': 16, 'P': 11}","{'C': 22, 'J': 16, 'Z': 16}","{'Q': 24, 'R': 16, 'S': 8, 'T': 8, 'H': 16, 'M': 8}","{'Y': 8, 'A': 8, 'B': 4, 'D': 4, 'E': 4, 'G': 8, 'I': 4, 'K': 8, 'L': 4, 'N': 4, 'O': 4, 'U': 8, 'V': 4, 'W': 4, 'X': 4}"
INV-ZZ-0000984,SCH-ZZ-0000004,1004,Boeing 787,08/24/2024,08/24/2024,MAA,VNS,270,294,149,-121,145,27,54,81,108,31,10,21,56,29,27,86,35,51,121,75,46,"{'F': 16, 'P': 11}","{'C': 22, 'J': 16, 'Z': 16}","{'Q': 24, 'R': 16, 'S': 8, 'T': 8, 'H': 16, 'M': 8}","{'Y': 8, 'A': 8, 'B': 4, 'D': 4, 'E': 4, 'G': 8, 'I': 4, 'K': 8, 'L': 4, 'N': 4, 'O': 4, 'U': 8, 'V': 4, 'W': 4, 'X': 4}"
INV-ZZ-0001048,SCH-ZZ-0000068,1004,Boeing 787,08/24/2024,08/24/2024,MAA,VNS,270,288,182,-88,106,27,54,81,108,30,17,13,58,50,8,84,65,19,116,50,66,"{'F': 16, 'P': 11}","{'C': 22, 'J': 16, 'Z': 16}","{'Q': 24, 'R': 16, 'S': 8, 'T': 8, 'H': 16, 'M': 8}","{'Y': 8, 'A': 8, 'B': 4, 'D': 4, 'E': 4, 'G': 8, 'I': 4, 'K': 8, 'L': 4, 'N': 4, 'O': 4, 'U': 8, 'V': 4, 'W': 4, 'X': 4}"
INV-ZZ-0001112,SCH-ZZ-0000132,1004,Boeing 787,08/24/2024,08/24/2024,MAA,VNS,270,293,211,-59,82,27,54,81,108,32,17,15,55,34,21,83,59,24,123,101,22,"{'F': 16, 'P': 11}","{'C': 22, 'J': 16, 'Z': 16}","{'Q': 24, 'R': 16, 'S': 8, 'T': 8, 'H': 16, 'M': 8}","{'Y': 8, 'A': 8, 'B': 4, 'D': 4, 'E': 4, 'G': 8, 'I': 4, 'K': 8, 'L': 4, 'N': 4, 'O': 4, 'U': 8, 'V': 4, 'W': 4, 'X': 4}"
INV-ZZ-0000985,SCH-ZZ-0000005,1005,Boeing 787,08/24/2024,08/24/2024,MAA,JFK,270,287,202,-68,85,27,54,81,108,29,22,7,56,23,33,89,73,16,113,84,29,"{'F': 16, 'P': 11}","{'C': 22, 'J': 16, 'Z': 16}","{'Q': 24, 'R': 16, 'S': 8, 'T': 8, 'H': 16, 'M': 8}","{'Y': 8, 'A': 8, 'B': 4, 'D': 4, 'E': 4, 'G': 8, 'I': 4, 'K': 8, 'L': 4, 'N': 4, 'O': 4, 'U': 8, 'V': 4, 'W': 4, 'X': 4}"
INV-ZZ-0001049,SCH-ZZ-0000069,1005,Boeing 787,08/24/2024,08/24/2024,MAA,JFK,270,298,217,-53,81,27,54,81,108,31,21,10,58,34,24,88,58,30,121,104,17,"{'F': 16, 'P': 11}","{'C': 22, 'J': 16, 'Z': 16}","{'Q': 24, 'R': 16, 'S': 8, 'T': 8, 'H': 16, 'M': 8}","{'Y': 8, 'A': 8, 'B': 4, 'D': 4, 'E': 4, 'G': 8, 'I': 4, 'K': 8, 'L': 4, 'N': 4, 'O': 4, 'U': 8, 'V': 4, 'W': 4, 'X': 4}"
INV-ZZ-0001113,SCH-ZZ-0000133,1005,Boeing 787,08/24/2024,08/24/2024,MAA,JFK,270,290,195,-75,95,27,54,81,108,31,20,11,60,27,33,89,40,49,110,108,2,"{'F': 16, 'P': 11}","{'C': 22, 'J': 16, 'Z': 16}","{'Q': 24, 'R': 16, 'S': 8, 'T': 8, 'H': 16, 'M': 8}","{'Y': 8, 'A': 8, 'B': 4, 'D': 4, 'E': 4, 'G': 8, 'I': 4, 'K': 8, 'L': 4, 'N': 4, 'O': 4, 'U': 8, 'V': 4, 'W': 4, 'X': 4}"
INV-ZZ-0000986,SCH-ZZ-0000006,1006,Boeing 787,08/24/2024,08/24/2024,MAA,DEL,270,295,208,-62,87,27,54,81,108,30,23,7,56,31,25,83,81,2,126,73,53,"{'F': 16, 'P': 11}","{'C': 22, 'J': 16, 'Z': 16}","{'Q': 24, 'R': 16, 'S': 8, 'T': 8, 'H': 16, 'M': 8}","{'Y': 8, 'A': 8, 'B': 4, 'D': 4, 'E': 4, 'G': 8, 'I': 4, 'K': 8, 'L': 4, 'N': 4, 'O': 4, 'U': 8, 'V': 4, 'W': 4, 'X': 4}"
INV-ZZ-0001050,SCH-ZZ-0000070,1006,Boeing 787,08/24/2024,08/24/2024,MAA,DEL,270,297,213,-57,84,27,54,81,108,31,18,13,60,50,10,91,77,14,115,68,47,"{'F': 16, 'P': 11}","{'C': 22, 'J': 16, 'Z': 16}","{'Q': 24, 'R': 16, 'S': 8, 'T': 8, 'H': 16, 'M': 8}","{'Y': 8, 'A': 8, 'B': 4, 'D': 4, 'E': 4, 'G': 8, 'I': 4, 'K': 8, 'L': 4, 'N': 4, 'O': 4, 'U': 8, 'V': 4, 'W': 4, 'X': 4}"
INV-ZZ-0001114,SCH-ZZ-0000134,1006,Boeing 787,08/24/2024,08/24/2024,MAA,DEL,270,294,152,-118,142,27,54,81,108,32,16,16,60,46,14,90,47,43,112,43,69,"{'F': 16, 'P': 11}","{'C': 22, 'J': 16, 'Z': 16}","{'Q': 24, 'R': 16, 'S': 8, 'T': 8, 'H': 16, 'M': 8}","{'Y': 8, 'A': 8, 'B': 4, 'D': 4, 'E': 4, 'G': 8, 'I': 4, 'K': 8, 'L': 4, 'N': 4, 'O': 4, 'U': 8, 'V': 4, 'W': 4, 'X': 4}"
INV-ZZ-0000987,SCH-ZZ-0000007,1007,Boeing 787,08/24/2024,08/24/2024,MAA,LAX,270,302,203,-67,99,27,54,81,108,31,21,10,56,26,30,87,60,27,128,96,32,"{'F': 16, 'P': 11}","{'C': 22, 'J': 16, 'Z': 16}","{'Q': 24, 'R': 16, 'S': 8, 'T': 8, 'H': 16, 'M': 8}","{'Y': 8, 'A': 8, 'B': 4, 'D': 4, 'E': 4, 'G': 8, 'I': 4, 'K': 8, 'L': 4, 'N': 4, 'O': 4, 'U': 8, 'V': 4, 'W': 4, 'X': 4}"
INV-ZZ-0001051,SCH-ZZ-0000071,1007,Boeing 787,08/24/2024,08/24/2024,MAA,LAX,270,292,214,-56,78,27,54,81,108,30,17,13,55,43,12,83,55,28,124,99,25,"{'F': 16, 'P': 11}","{'C': 22, 'J': 16, 'Z': 16}","{'Q': 24, 'R': 16, 'S': 8, 'T': 8, 'H': 16, 'M': 8}","{'Y': 8, 'A': 8, 'B': 4, 'D': 4, 'E': 4, 'G': 8, 'I': 4, 'K': 8, 'L': 4, 'N': 4, 'O': 4, 'U': 8, 'V': 4, 'W': 4, 'X': 4}"
INV-ZZ-0001115,SCH-ZZ-0000135,1007,Boeing 787,08/24/2024,08/24/2024,MAA,LAX,270,287,230,-40,57,27,54,81,108,31,10,21,60,46,14,82,80,2,114,94,20,"{'F': 16, 'P': 11}","{'C': 22, 'J': 16, 'Z': 16}","{'Q': 24, 'R': 16, 'S': 8, 'T': 8, 'H': 16, 'M': 8}","{'Y': 8, 'A': 8, 'B': 4, 'D': 4, 'E': 4, 'G': 8, 'I': 4, 'K': 8, 'L': 4, 'N': 4, 'O': 4, 'U': 8, 'V': 4, 'W': 4, 'X': 4}"
INV-ZZ-0000988,SCH-ZZ-0000008,1008,Boeing 787,08/24/2024,08/24/2024,BLR,MAA,270,288,206,-64,82,27,54,81,108,30,22,8,55,47,8,85,52,33,118,85,33,"{'F': 16, 'P': 11}","{'C': 22, 'J': 16, 'Z': 16}","{'Q': 24, 'R': 16, 'S': 8, 'T': 8, 'H': 16, 'M': 8}","{'Y': 8, 'A': 8, 'B': 4, 'D': 4, 'E': 4, 'G': 8, 'I': 4, 'K': 8, 'L': 4, 'N': 4, 'O': 4, 'U': 8, 'V': 4, 'W': 4, 'X': 4}"
INV-ZZ-0001052,SCH-ZZ-0000072,1008,Boeing 787,08/24/2024,08/24/2024,BLR,MAA,270,301,199,-71,102,27,54,81,108,31,15,16,56,54,2,87,77,10,127,53,74,"{'F': 16, 'P': 11}","{'C': 22, 'J': 16, 'Z': 16}","{'Q': 24, 'R': 16, 'S': 8, 'T': 8, 'H': 16, 'M': 8}","{'Y': 8, 'A': 8, 'B': 4, 'D': 4, 'E': 4, 'G': 8, 'I': 4, 'K': 8, 'L': 4, 'N': 4, 'O': 4, 'U': 8, 'V': 4, 'W': 4, 'X': 4}"
INV-ZZ-0001116,SCH-ZZ-0000136,1008,Boeing 787,08/24/2024,08/24/2024,BLR,MAA,270,282,231,-39,51,27,54,81,108,30,23,7,56,26,30,83,79,4,113,103,10,"{'F': 16, 'P': 11}","{'C': 22, 'J': 16, 'Z': 16}","{'Q': 24, 'R': 16, 'S': 8, 'T': 8, 'H': 16, 'M': 8}","{'Y': 8, 'A': 8, 'B': 4, 'D': 4, 'E': 4, 'G': 8, 'I': 4, 'K': 8, 'L': 4, 'N': 4, 'O': 4, 'U': 8, 'V': 4, 'W': 4, 'X': 4}"
INV-ZZ-0000990,SCH-ZZ-0000010,1010,Boeing 787,08/24/2024,08/24/2024,BLR,BOM,270,289,138,-132,151,27,54,81,108,31,27,4,59,21,38,86,50,36,113,40,73,"{'F': 16, 'P': 11}","{'C': 22, 'J': 16, 'Z': 16}","{'Q': 24, 'R': 16, 'S': 8, 'T': 8, 'H': 16, 'M': 8}","{'Y': 8, 'A': 8, 'B': 4, 'D': 4, 'E': 4, 'G': 8, 'I': 4, 'K': 8, 'L': 4, 'N': 4, 'O': 4, 'U': 8, 'V': 4, 'W': 4, 'X': 4}"
INV-ZZ-0001054,SCH-ZZ-0000074,1010,Boeing 787,08/24/2024,08/24/2024,BLR,BOM,270,298,186,-84,112,27,54,81,108,32,13,19,57,50,7,82,80,2,127,43,84,"{'F': 16, 'P': 11}","{'C': 22, 'J': 16, 'Z': 16}","{'Q': 24, 'R': 16, 'S': 8, 'T': 8, 'H': 16, 'M': 8}","{'Y': 8, 'A': 8, 'B': 4, 'D': 4, 'E': 4, 'G': 8, 'I': 4, 'K': 8, 'L': 4, 'N': 4, 'O': 4, 'U': 8, 'V': 4, 'W': 4, 'X': 4}"
INV-ZZ-0001118,SCH-ZZ-0000138,1010,Boeing 787,08/24/2024,08/24/2024,BLR,BOM,270,305,249,-21,56,27,54,81,108,31,19,12,58,51,7,91,80,11,125,99,26,"{'F': 16, 'P': 11}","{'C': 22, 'J': 16, 'Z': 16}","{'Q': 24, 'R': 16, 'S': 8, 'T': 8, 'H': 16, 'M': 8}","{'Y': 8, 'A': 8, 'B': 4, 'D': 4, 'E': 4, 'G': 8, 'I': 4, 'K': 8, 'L': 4, 'N': 4, 'O': 4, 'U': 8, 'V': 4, 'W': 4, 'X': 4}"
INV-ZZ-0000991,SCH-ZZ-0000011,1011,Boeing 787,08/24/2024,08/24/2024,BLR,DUB,270,300,180,-90,120,27,54,81,108,28,17,11,59,30,29,85,74,11,128,59,69,"{'F': 16, 'P': 11}","{'C': 22, 'J': 16, 'Z': 16}","{'Q': 24, 'R': 16, 'S': 8, 'T': 8, 'H': 16, 'M': 8}","{'Y': 8, 'A': 8, 'B': 4, 'D': 4, 'E': 4, 'G': 8, 'I': 4, 'K': 8, 'L': 4, 'N': 4, 'O': 4, 'U': 8, 'V': 4, 'W': 4, 'X': 4}"
INV-ZZ-0001055,SCH-ZZ-0000075,1011,Boeing 787,08/24/2024,08/24/2024,BLR,DUB,270,291,210,-60,81,27,54,81,108,29,20,9,56,34,22,87,74,13,119,82,37,"{'F': 16, 'P': 11}","{'C': 22, 'J': 16, 'Z': 16}","{'Q': 24, 'R': 16, 'S': 8, 'T': 8, 'H': 16, 'M': 8}","{'Y': 8, 'A': 8, 'B': 4, 'D': 4, 'E': 4, 'G': 8, 'I': 4, 'K': 8, 'L': 4, 'N': 4, 'O': 4, 'U': 8, 'V': 4, 'W': 4, 'X': 4}"
INV-ZZ-0001119,SCH-ZZ-0000139,1011,Boeing 787,08/24/2024,08/24/2024,BLR,DUB,270,294,199,-71,95,27,54,81,108,29,13,16,59,53,6,88,72,16,118,61,57,"{'F': 16, 'P': 11}","{'C': 22, 'J': 16, 'Z': 16}","{'Q': 24, 'R': 16, 'S': 8, 'T': 8, 'H': 16, 'M': 8}","{'Y': 8, 'A': 8, 'B': 4, 'D': 4, 'E': 4, 'G': 8, 'I': 4, 'K': 8, 'L': 4, 'N': 4, 'O': 4, 'U': 8, 'V': 4, 'W': 4, 'X': 4}"
INV-ZZ-0000992,SCH-ZZ-0000012,1012,Boeing 787,08/24/2024,08/24/2024,BLR,VNS,270,303,229,-41,74,27,54,81,108,31,27,4,55,45,10,91,50,41,126,107,19,"{'F': 16, 'P': 11}","{'C': 22, 'J': 16, 'Z': 16}","{'Q': 24, 'R': 16, 'S': 8, 'T': 8, 'H': 16, 'M': 8}","{'Y': 8, 'A': 8, 'B': 4, 'D': 4, 'E': 4, 'G': 8, 'I': 4, 'K': 8, 'L': 4, 'N': 4, 'O': 4, 'U': 8, 'V': 4, 'W': 4, 'X': 4}"
INV-ZZ-0001056,SCH-ZZ-0000076,1012,Boeing 787,08/24/2024,08/24/2024,BLR,VNS,270,305,153,-117,152,27,54,81,108,31,19,12,58,20,38,88,67,21,128,47,81,"{'F': 16, 'P': 11}","{'C': 22, 'J': 16, 'Z': 16}","{'Q': 24, 'R': 16, 'S': 8, 'T': 8, 'H': 16, 'M': 8}","{'Y': 8, 'A': 8, 'B': 4, 'D': 4, 'E': 4, 'G': 8, 'I': 4, 'K': 8, 'L': 4, 'N': 4, 'O': 4, 'U': 8, 'V': 4, 'W': 4, 'X': 4}"
INV-ZZ-0001120,SCH-ZZ-0000140,1012,Boeing 787,08/24/2024,08/24/2024,BLR,VNS,270,282,198,-72,84,27,54,81,108,31,27,4,57,40,17,85,54,31,109,77,32,"{'F': 16, 'P': 11}","{'C': 22, 'J': 16, 'Z': 16}","{'Q': 24, 'R': 16, 'S': 8, 'T': 8, 'H': 16, 'M': 8}","{'Y': 8, 'A': 8, 'B': 4, 'D': 4, 'E': 4, 'G': 8, 'I': 4, 'K': 8, 'L': 4, 'N': 4, 'O': 4, 'U': 8, 'V': 4, 'W': 4, 'X': 4}"
INV-ZZ-0000993,SCH-ZZ-0000013,1013,Boeing 787,08/24/2024,08/24/2024,BLR,JFK,270,292,206,-64,86,27,54,81,108,29,25,4,56,35,21,86,43,43,121,103,18,"{'F': 16, 'P': 11}","{'C': 22, 'J': 16, 'Z': 16}","{'Q': 24, 'R': 16, 'S': 8, 'T': 8, 'H': 16, 'M': 8}","{'Y': 8, 'A': 8, 'B': 4, 'D': 4, 'E': 4, 'G': 8, 'I': 4, 'K': 8, 'L': 4, 'N': 4, 'O': 4, 'U': 8, 'V': 4, 'W': 4, 'X': 4}"
INV-ZZ-0001057,SCH-ZZ-0000077,1013,Boeing 787,08/24/2024,08/24/2024,BLR,JFK,270,280,181,-89,99,27,54,81,108,30,25,5,55,21,34,84,35,49,111,100,11,"{'F': 16, 'P': 11}","{'C': 22, 'J': 16, 'Z': 16}","{'Q': 24, 'R': 16, 'S': 8, 'T': 8, 'H': 16, 'M': 8}","{'Y': 8, 'A': 8, 'B': 4, 'D': 4, 'E': 4, 'G': 8, 'I': 4, 'K': 8, 'L': 4, 'N': 4, 'O': 4, 'U': 8, 'V': 4, 'W': 4, 'X': 4}"
INV-ZZ-0001121,SCH-ZZ-0000141,1013,Boeing 787,08/24/2024,08/24/2024,BLR,JFK,270,292,165,-105,127,27,54,81,108,30,17,13,61,28,33,89,39,50,112,81,31,"{'F': 16, 'P': 11}","{'C': 22, 'J': 16, 'Z': 16}","{'Q': 24, 'R': 16, 'S': 8, 'T': 8, 'H': 16, 'M': 8}","{'Y': 8, 'A': 8, 'B': 4, 'D': 4, 'E': 4, 'G': 8, 'I': 4, 'K': 8, 'L': 4, 'N': 4, 'O': 4, 'U': 8, 'V': 4, 'W': 4, 'X': 4}"
INV-ZZ-0000994,SCH-ZZ-0000014,1014,Boeing 787,08/24/2024,08/24/2024,BLR,DEL,270,286,192,-78,94,27,54,81,108,28,11,17,59,29,30,89,70,19,110,82,28,"{'F': 16, 'P': 11}","{'C': 22, 'J': 16, 'Z': 16}","{'Q': 24, 'R': 16, 'S': 8, 'T': 8, 'H': 16, 'M': 8}","{'Y': 8, 'A': 8, 'B': 4, 'D': 4, 'E': 4, 'G': 8, 'I': 4, 'K': 8, 'L': 4, 'N': 4, 'O': 4, 'U': 8, 'V': 4, 'W': 4, 'X': 4}"
INV-ZZ-0001058,SCH-ZZ-0000078,1014,Boeing 787,08/24/2024,08/24/2024,BLR,DEL,270,285,160,-110,125,27,54,81,108,31,21,10,55,34,21,87,37,50,112,68,44,"{'F': 16, 'P': 11}","{'C': 22, 'J': 16, 'Z': 16}","{'Q': 24, 'R': 16, 'S': 8, 'T': 8, 'H': 16, 'M': 8}","{'Y': 8, 'A': 8, 'B': 4, 'D': 4, 'E': 4, 'G': 8, 'I': 4, 'K': 8, 'L': 4, 'N': 4, 'O': 4, 'U': 8, 'V': 4, 'W': 4, 'X': 4}"
INV-ZZ-0001122,SCH-ZZ-0000142,1014,Boeing 787,08/24/2024,08/24/2024,BLR,DEL,270,292,172,-98,120,27,54,81,108,32,13,19,61,29,32,88,36,52,111,94,17,"{'F': 16, 'P': 11}","{'C': 22, 'J': 16, 'Z': 16}","{'Q': 24, 'R': 16, 'S': 8, 'T': 8, 'H': 16, 'M': 8}","{'Y': 8, 'A': 8, 'B': 4, 'D': 4, 'E': 4, 'G': 8, 'I': 4, 'K': 8, 'L': 4, 'N': 4, 'O': 4, 'U': 8, 'V': 4, 'W': 4, 'X': 4}"
INV-ZZ-0000995,SCH-ZZ-0000015,1015,Boeing 787,08/24/2024,08/24/2024,BLR,LAX,270,286,212,-58,74,27,54,81,108,30,12,18,55,23,32,88,76,12,113,101,12,"{'F': 16, 'P': 11}","{'C': 22, 'J': 16, 'Z': 16}","{'Q': 24, 'R': 16, 'S': 8, 'T': 8, 'H': 16, 'M': 8}","{'Y': 8, 'A': 8, 'B': 4, 'D': 4, 'E': 4, 'G': 8, 'I': 4, 'K': 8, 'L': 4, 'N': 4, 'O': 4, 'U': 8, 'V': 4, 'W': 4, 'X': 4}"
INV-ZZ-0001059,SCH-ZZ-0000079,1015,Boeing 787,08/24/2024,08/24/2024,BLR,LAX,270,281,181,-89,100,27,54,81,108,30,13,17,55,36,19,86,46,40,110,86,24,"{'F': 16, 'P': 11}","{'C': 22, 'J': 16, 'Z': 16}","{'Q': 24, 'R': 16, 'S': 8, 'T': 8, 'H': 16, 'M': 8}","{'Y': 8, 'A': 8, 'B': 4, 'D': 4, 'E': 4, 'G': 8, 'I': 4, 'K': 8, 'L': 4, 'N': 4, 'O': 4, 'U': 8, 'V': 4, 'W': 4, 'X': 4}"
INV-ZZ-0001123,SCH-ZZ-0000143,1015,Boeing 787,08/24/2024,08/24/2024,BLR,LAX,270,295,165,-105,130,27,54,81,108,32,20,12,55,37,18,85,57,28,123,51,72,"{'F': 16, 'P': 11}","{'C': 22, 'J': 16, 'Z': 16}","{'Q': 24, 'R': 16, 'S': 8, 'T': 8, 'H': 16, 'M': 8}","{'Y': 8, 'A': 8, 'B': 4, 'D': 4, 'E': 4, 'G': 8, 'I': 4, 'K': 8, 'L': 4, 'N': 4, 'O': 4, 'U': 8, 'V': 4, 'W': 4, 'X': 4}"
INV-ZZ-0000996,SCH-ZZ-0000016,1016,Boeing 787,08/24/2024,08/24/2024,BOM,MAA,270,281,182,-88,99,27,54,81,108,29,21,8,56,43,13,83,67,16,113,51,62,"{'F': 16, 'P': 11}","{'C': 22, 'J': 16, 'Z': 16}","{'Q': 24, 'R': 16, 'S': 8, 'T': 8, 'H': 16, 'M': 8}","{'Y': 8, 'A': 8, 'B': 4, 'D': 4, 'E': 4, 'G': 8, 'I': 4, 'K': 8, 'L': 4, 'N': 4, 'O': 4, 'U': 8, 'V': 4, 'W': 4, 'X': 4}"
INV-ZZ-0001060,SCH-ZZ-0000080,1016,Boeing 787,08/24/2024,08/24/2024,BOM,MAA,270,288,189,-81,99,27,54,81,108,32,20,12,56,32,24,83,58,25,117,79,38,"{'F': 16, 'P': 11}","{'C': 22, 'J': 16, 'Z': 16}","{'Q': 24, 'R': 16, 'S': 8, 'T': 8, 'H': 16, 'M': 8}","{'Y': 8, 'A': 8, 'B': 4, 'D': 4, 'E': 4, 'G': 8, 'I': 4, 'K': 8, 'L': 4, 'N': 4, 'O': 4, 'U': 8, 'V': 4, 'W': 4, 'X': 4}"
INV-ZZ-0001124,SCH-ZZ-0000144,1016,Boeing 787,08/24/2024,08/24/2024,BOM,MAA,270,297,131,-139,166,27,54,81,108,31,14,17,55,25,30,90,46,44,121,46,75,"{'F': 16, 'P': 11}","{'C': 22, 'J': 16, 'Z': 16}","{'Q': 24, 'R': 16, 'S': 8, 'T': 8, 'H': 16, 'M': 8}","{'Y': 8, 'A': 8, 'B': 4, 'D': 4, 'E': 4, 'G': 8, 'I': 4, 'K': 8, 'L': 4, 'N': 4, 'O': 4, 'U': 8, 'V': 4, 'W': 4, 'X': 4}"
INV-ZZ-0000997,SCH-ZZ-0000017,1017,Boeing 787,08/24/2024,08/24/2024,BOM,BLR,270,293,228,-42,65,27,54,81,108,32,20,12,58,39,19,88,63,25,115,106,9,"{'F': 16, 'P': 11}","{'C': 22, 'J': 16, 'Z': 16}","{'Q': 24, 'R': 16, 'S': 8, 'T': 8, 'H': 16, 'M': 8}","{'Y': 8, 'A': 8, 'B': 4, 'D': 4, 'E': 4, 'G': 8, 'I': 4, 'K': 8, 'L': 4, 'N': 4, 'O': 4, 'U': 8, 'V': 4, 'W': 4, 'X': 4}"
INV-ZZ-0001061,SCH-ZZ-0000081,1017,Boeing 787,08/24/2024,08/24/2024,BOM,BLR,270,285,195,-75,90,27,54,81,108,31,10,21,55,50,5,88,68,20,111,67,44,"{'F': 16, 'P': 11}","{'C': 22, 'J': 16, 'Z': 16}","{'Q': 24, 'R': 16, 'S': 8, 'T': 8, 'H': 16, 'M': 8}","{'Y': 8, 'A': 8, 'B': 4, 'D': 4, 'E': 4, 'G': 8, 'I': 4, 'K': 8, 'L': 4, 'N': 4, 'O': 4, 'U': 8, 'V': 4, 'W': 4, 'X': 4}"
INV-ZZ-0001125,SCH-ZZ-0000145,1017,Boeing 787,08/24/2024,08/24/2024,BOM,BLR,270,285,149,-121,136,27,54,81,108,31,26,5,55,40,15,89,40,49,110,43,67,"{'F': 16, 'P': 11}","{'C': 22, 'J': 16, 'Z': 16}","{'Q': 24, 'R': 16, 'S': 8, 'T': 8, 'H': 16, 'M': 8}","{'Y': 8, 'A': 8, 'B': 4, 'D': 4, 'E': 4, 'G': 8, 'I': 4, 'K': 8, 'L': 4, 'N': 4, 'O': 4, 'U': 8, 'V': 4, 'W': 4, 'X': 4}"
INV-ZZ-0000999,SCH-ZZ-0000019,1019,Boeing 787,08/24/2024,08/24/2024,BOM,DUB,270,296,200,-70,96,27,54,81,108,31,16,15,60,44,16,83,69,14,122,71,51,"{'F': 16, 'P': 11}","{'C': 22, 'J': 16, 'Z': 16}","{'Q': 24, 'R': 16, 'S': 8, 'T': 8, 'H': 16, 'M': 8}","{'Y': 8, 'A': 8, 'B': 4, 'D': 4, 'E': 4, 'G': 8, 'I': 4, 'K': 8, 'L': 4, 'N': 4, 'O': 4, 'U': 8, 'V': 4, 'W': 4, 'X': 4}"
INV-ZZ-0001063,SCH-ZZ-0000083,1019,Boeing 787,08/24/2024,08/24/2024,BOM,DUB,270,306,182,-88,124,27,54,81,108,30,19,11,60,21,39,88,64,24,128,78,50,"{'F': 16, 'P': 11}","{'C': 22, 'J': 16, 'Z': 16}","{'Q': 24, 'R': 16, 'S': 8, 'T': 8, 'H': 16, 'M': 8}","{'Y': 8, 'A': 8, 'B': 4, 'D': 4, 'E': 4, 'G': 8, 'I': 4, 'K': 8, 'L': 4, 'N': 4, 'O': 4, 'U': 8, 'V': 4, 'W': 4, 'X': 4}"
INV-ZZ-0001127,SCH-ZZ-0000147,1019,Boeing 787,08/24/2024,08/24/2024,BOM,DUB,270,292,137,-133,155,27,54,81,108,28,24,4,59,21,38,85,45,40,120,47,73,"{'F': 16, 'P': 11}","{'C': 22, 'J': 16, 'Z': 16}","{'Q': 24, 'R': 16, 'S': 8, 'T': 8, 'H': 16, 'M': 8}","{'Y': 8, 'A': 8, 'B': 4, 'D': 4, 'E': 4, 'G': 8, 'I': 4, 'K': 8, 'L': 4, 'N': 4, 'O': 4, 'U': 8, 'V': 4, 'W': 4, 'X': 4}"
INV-ZZ-0001000,SCH-ZZ-0000020,1020,Boeing 787,08/24/2024,08/24/2024,BOM,VNS,270,292,158,-112,134,27,54,81,108,31,21,10,59,20,39,86,63,23,116,54,62,"{'F': 16, 'P': 11}","{'C': 22, 'J': 16, 'Z': 16}","{'Q': 24, 'R': 16, 'S': 8, 'T': 8, 'H': 16, 'M': 8}","{'Y': 8, 'A': 8, 'B': 4, 'D': 4, 'E': 4, 'G': 8, 'I': 4, 'K': 8, 'L': 4, 'N': 4, 'O': 4, 'U': 8, 'V': 4, 'W': 4, 'X': 4}"
INV-ZZ-0001064,SCH-ZZ-0000084,1020,Boeing 787,08/24/2024,08/24/2024,BOM,VNS,270,302,132,-138,170,27,54,81,108,29,11,18,55,21,34,90,56,34,128,44,84,"{'F': 16, 'P': 11}","{'C': 22, 'J': 16, 'Z': 16}","{'Q': 24, 'R': 16, 'S': 8, 'T': 8, 'H': 16, 'M': 8}","{'Y': 8, 'A': 8, 'B': 4, 'D': 4, 'E': 4, 'G': 8, 'I': 4, 'K': 8, 'L': 4, 'N': 4, 'O': 4, 'U': 8, 'V': 4, 'W': 4, 'X': 4}"
INV-ZZ-0001128,SCH-ZZ-0000148,1020,Boeing 787,08/24/2024,08/24/2024,BOM,VNS,270,282,178,-92,104,27,54,81,108,29,10,19,59,47,12,85,62,23,109,59,50,"{'F': 16, 'P': 11}","{'C': 22, 'J': 16, 'Z': 16}","{'Q': 24, 'R': 16, 'S': 8, 'T': 8, 'H': 16, 'M': 8}","{'Y': 8, 'A': 8, 'B': 4, 'D': 4, 'E': 4, 'G': 8, 'I': 4, 'K': 8, 'L': 4, 'N': 4, 'O': 4, 'U': 8, 'V': 4, 'W': 4, 'X': 4}"
INV-ZZ-0001001,SCH-ZZ-0000021,1021,Boeing 787,08/24/2024,08/24/2024,BOM,JFK,270,296,170,-100,126,27,54,81,108,30,24,6,58,26,32,91,40,51,117,80,37,"{'F': 16, 'P': 11}","{'C': 22, 'J': 16, 'Z': 16}","{'Q': 24, 'R': 16, 'S': 8, 'T': 8, 'H': 16, 'M': 8}","{'Y': 8, 'A': 8, 'B': 4, 'D': 4, 'E': 4, 'G': 8, 'I': 4, 'K': 8, 'L': 4, 'N': 4, 'O': 4, 'U': 8, 'V': 4, 'W': 4, 'X': 4}"
INV-ZZ-0001065,SCH-ZZ-0000085,1021,Boeing 787,08/24/2024,08/24/2024,BOM,JFK,270,281,192,-78,89,27,54,81,108,31,18,13,56,34,22,82,66,16,112,74,38,"{'F': 16, 'P': 11}","{'C': 22, 'J': 16, 'Z': 16}","{'Q': 24, 'R': 16, 'S': 8, 'T': 8, 'H': 16, 'M': 8}","{'Y': 8, 'A': 8, 'B': 4, 'D': 4, 'E': 4, 'G': 8, 'I': 4, 'K': 8, 'L': 4, 'N': 4, 'O': 4, 'U': 8, 'V': 4, 'W': 4, 'X': 4}"
INV-ZZ-0001129,SCH-ZZ-0000149,1021,Boeing 787,08/24/2024,08/24/2024,BOM,JFK,270,295,188,-82,107,27,54,81,108,30,14,16,56,38,18,87,72,15,122,64,58,"{'F': 16, 'P': 11}","{'C': 22, 'J': 16, 'Z': 16}","{'Q': 24, 'R': 16, 'S': 8, 'T': 8, 'H': 16, 'M': 8}","{'Y': 8, 'A': 8, 'B': 4, 'D': 4, 'E': 4, 'G': 8, 'I': 4, 'K': 8, 'L': 4, 'N': 4, 'O': 4, 'U': 8, 'V': 4, 'W': 4, 'X': 4}"
INV-ZZ-0001002,SCH-ZZ-0000022,1022,Boeing 787,08/24/2024,08/24/2024,BOM,DEL,270,290,205,-65,85,27,54,81,108,29,25,4,60,45,15,82,54,28,119,81,38,"{'F': 16, 'P': 11}","{'C': 22, 'J': 16, 'Z': 16}","{'Q': 24, 'R': 16, 'S': 8, 'T': 8, 'H': 16, 'M': 8}","{'Y': 8, 'A': 8, 'B': 4, 'D': 4, 'E': 4, 'G': 8, 'I': 4, 'K': 8, 'L': 4, 'N': 4, 'O': 4, 'U': 8, 'V': 4, 'W': 4, 'X': 4}"
INV-ZZ-0001066,SCH-ZZ-0000086,1022,Boeing 787,08/24/2024,08/24/2024,BOM,DEL,270,290,200,-70,90,27,54,81,108,28,10,18,58,43,15,84,65,19,120,82,38,"{'F': 16, 'P': 11}","{'C': 22, 'J': 16, 'Z': 16}","{'Q': 24, 'R': 16, 'S': 8, 'T': 8, 'H': 16, 'M': 8}","{'Y': 8, 'A': 8, 'B': 4, 'D': 4, 'E': 4, 'G': 8, 'I': 4, 'K': 8, 'L': 4, 'N': 4, 'O': 4, 'U': 8, 'V': 4, 'W': 4, 'X': 4}"
INV-ZZ-0001130,SCH-ZZ-0000150,1022,Boeing 787,08/24/2024,08/24/2024,BOM,DEL,270,299,189,-81,110,27,54,81,108,31,24,7,60,41,19,82,61,21,126,63,63,"{'F': 16, 'P': 11}","{'C': 22, 'J': 16, 'Z': 16}","{'Q': 24, 'R': 16, 'S': 8, 'T': 8, 'H': 16, 'M': 8}","{'Y': 8, 'A': 8, 'B': 4, 'D': 4, 'E': 4, 'G': 8, 'I': 4, 'K': 8, 'L': 4, 'N': 4, 'O': 4, 'U': 8, 'V': 4, 'W': 4, 'X': 4}"
INV-ZZ-0001003,SCH-ZZ-0000023,1023,Boeing 787,08/24/2024,08/24/2024,BOM,LAX,270,284,181,-89,103,27,54,81,108,28,24,4,56,41,15,87,73,14,113,43,70,"{'F': 16, 'P': 11}","{'C': 22, 'J': 16, 'Z': 16}","{'Q': 24, 'R': 16, 'S': 8, 'T': 8, 'H': 16, 'M': 8}","{'Y': 8, 'A': 8, 'B': 4, 'D': 4, 'E': 4, 'G': 8, 'I': 4, 'K': 8, 'L': 4, 'N': 4, 'O': 4, 'U': 8, 'V': 4, 'W': 4, 'X': 4}"
INV-ZZ-0001067,SCH-ZZ-0000087,1023,Boeing 787,08/24/2024,08/24/2024,BOM,LAX,270,283,209,-61,74,27,54,81,108,28,12,16,55,28,27,82,78,4,118,91,27,"{'F': 16, 'P': 11}","{'C': 22, 'J': 16, 'Z': 16}","{'Q': 24, 'R': 16, 'S': 8, 'T': 8, 'H': 16, 'M': 8}","{'Y': 8, 'A': 8, 'B': 4, 'D': 4, 'E': 4, 'G': 8, 'I': 4, 'K': 8, 'L': 4, 'N': 4, 'O': 4, 'U': 8, 'V': 4, 'W': 4, 'X': 4}"
INV-ZZ-0001131,SCH-ZZ-0000151,1023,Boeing 787,08/24/2024,08/24/2024,BOM,LAX,270,294,160,-110,134,27,54,81,108,28,12,16,57,35,22,91,63,28,118,50,68,"{'F': 16, 'P': 11}","{'C': 22, 'J': 16, 'Z': 16}","{'Q': 24, 'R': 16, 'S': 8, 'T': 8, 'H': 16, 'M': 8}","{'Y': 8, 'A': 8, 'B': 4, 'D': 4, 'E': 4, 'G': 8, 'I': 4, 'K': 8, 'L': 4, 'N': 4, 'O': 4, 'U': 8, 'V': 4, 'W': 4, 'X': 4}"
INV-ZZ-0001004,SCH-ZZ-0000024,1024,Boeing 787,08/24/2024,08/24/2024,DUB,MAA,270,288,171,-99,117,27,54,81,108,29,19,10,56,22,34,86,59,27,117,71,46,"{'F': 16, 'P': 11}","{'C': 22, 'J': 16, 'Z': 16}","{'Q': 24, 'R': 16, 'S': 8, 'T': 8, 'H': 16, 'M': 8}","{'Y': 8, 'A': 8, 'B': 4, 'D': 4, 'E': 4, 'G': 8, 'I': 4, 'K': 8, 'L': 4, 'N': 4, 'O': 4, 'U': 8, 'V': 4, 'W': 4, 'X': 4}"
INV-ZZ-0001068,SCH-ZZ-0000088,1024,Boeing 787,08/24/2024,08/24/2024,DUB,MAA,270,292,193,-77,99,27,54,81,108,31,16,15,55,27,28,84,58,26,122,92,30,"{'F': 16, 'P': 11}","{'C': 22, 'J': 16, 'Z': 16}","{'Q': 24, 'R': 16, 'S': 8, 'T': 8, 'H': 16, 'M': 8}","{'Y': 8, 'A': 8, 'B': 4, 'D': 4, 'E': 4, 'G': 8, 'I': 4, 'K': 8, 'L': 4, 'N': 4, 'O': 4, 'U': 8, 'V': 4, 'W': 4, 'X': 4}"
INV-ZZ-0001132,SCH-ZZ-0000152,1024,Boeing 787,08/24/2024,08/24/2024,DUB,MAA,270,303,175,-95,128,27,54,81,108,31,10,21,61,44,17,90,45,45,121,76,45,"{'F': 16, 'P': 11}","{'C': 22, 'J': 16, 'Z': 16}","{'Q': 24, 'R': 16, 'S': 8, 'T': 8, 'H': 16, 'M': 8}","{'Y': 8, 'A': 8, 'B': 4, 'D': 4, 'E': 4, 'G': 8, 'I': 4, 'K': 8, 'L': 4, 'N': 4, 'O': 4, 'U': 8, 'V': 4, 'W': 4, 'X': 4}"
INV-ZZ-0001005,SCH-ZZ-0000025,1025,Boeing 787,08/24/2024,08/24/2024,DUB,BLR,270,289,171,-99,118,27,54,81,108,28,13,15,57,43,14,82,38,44,122,77,45,"{'F': 16, 'P': 11}","{'C': 22, 'J': 16, 'Z': 16}","{'Q': 24, 'R': 16, 'S': 8, 'T': 8, 'H': 16, 'M': 8}","{'Y': 8, 'A': 8, 'B': 4, 'D': 4, 'E': 4, 'G': 8, 'I': 4, 'K': 8, 'L': 4, 'N': 4, 'O': 4, 'U': 8, 'V': 4, 'W': 4, 'X': 4}"
INV-ZZ-0001069,SCH-ZZ-0000089,1025,Boeing 787,08/24/2024,08/24/2024,DUB,BLR,270,303,204,-66,99,27,54,81,108,30,10,20,61,38,23,89,62,27,123,94,29,"{'F': 16, 'P': 11}","{'C': 22, 'J': 16, 'Z': 16}","{'Q': 24, 'R': 16, 'S': 8, 'T': 8, 'H': 16, 'M': 8}","{'Y': 8, 'A': 8, 'B': 4, 'D': 4, 'E': 4, 'G': 8, 'I': 4, 'K': 8, 'L': 4, 'N': 4, 'O': 4, 'U': 8, 'V': 4, 'W': 4, 'X': 4}"
INV-ZZ-0001133,SCH-ZZ-0000153,1025,Boeing 787,08/24/2024,08/24/2024,DUB,BLR,270,281,179,-91,102,27,54,81,108,30,15,15,58,46,12,82,58,24,111,60,51,"{'F': 16, 'P': 11}","{'C': 22, 'J': 16, 'Z': 16}","{'Q': 24, 'R': 16, 'S': 8, 'T': 8, 'H': 16, 'M': 8}","{'Y': 8, 'A': 8, 'B': 4, 'D': 4, 'E': 4, 'G': 8, 'I': 4, 'K': 8, 'L': 4, 'N': 4, 'O': 4, 'U': 8, 'V': 4, 'W': 4, 'X': 4}"
INV-ZZ-0001006,SCH-ZZ-0000026,1026,Boeing 787,08/24/2024,08/24/2024,DUB,BOM,270,296,197,-73,99,27,54,81,108,30,20,10,60,49,11,88,69,19,118,59,59,"{'F': 16, 'P': 11}","{'C': 22, 'J': 16, 'Z': 16}","{'Q': 24, 'R': 16, 'S': 8, 'T': 8, 'H': 16, 'M': 8}","{'Y': 8, 'A': 8, 'B': 4, 'D': 4, 'E': 4, 'G': 8, 'I': 4, 'K': 8, 'L': 4, 'N': 4, 'O': 4, 'U': 8, 'V': 4, 'W': 4, 'X': 4}"
INV-ZZ-0001070,SCH-ZZ-0000090,1026,Boeing 787,08/24/2024,08/24/2024,DUB,BOM,270,286,220,-50,66,27,54,81,108,32,19,13,57,20,37,87,73,14,110,108,2,"{'F': 16, 'P': 11}","{'C': 22, 'J': 16, 'Z': 16}","{'Q': 24, 'R': 16, 'S': 8, 'T': 8, 'H': 16, 'M': 8}","{'Y': 8, 'A': 8, 'B': 4, 'D': 4, 'E': 4, 'G': 8, 'I': 4, 'K': 8, 'L': 4, 'N': 4, 'O': 4, 'U': 8, 'V': 4, 'W': 4, 'X': 4}"
INV-ZZ-0001134,SCH-ZZ-0000154,1026,Boeing 787,08/24/2024,08/24/2024,DUB,BOM,270,292,190,-80,102,27,54,81,108,32,14,18,59,39,20,86,75,11,115,62,53,"{'F': 16, 'P': 11}","{'C': 22, 'J': 16, 'Z': 16}","{'Q': 24, 'R': 16, 'S': 8, 'T': 8, 'H': 16, 'M': 8}","{'Y': 8, 'A': 8, 'B': 4, 'D': 4, 'E': 4, 'G': 8, 'I': 4, 'K': 8, 'L': 4, 'N': 4, 'O': 4, 'U': 8, 'V': 4, 'W': 4, 'X': 4}"
INV-ZZ-0001008,SCH-ZZ-0000028,1028,Boeing 787,08/24/2024,08/24/2024,DUB,VNS,270,292,217,-53,75,27,54,81,108,29,21,8,57,43,14,83,58,25,123,95,28,"{'F': 16, 'P': 11}","{'C': 22, 'J': 16, 'Z': 16}","{'Q': 24, 'R': 16, 'S': 8, 'T': 8, 'H': 16, 'M': 8}","{'Y': 8, 'A': 8, 'B': 4, 'D': 4, 'E': 4, 'G': 8, 'I': 4, 'K': 8, 'L': 4, 'N': 4, 'O': 4, 'U': 8, 'V': 4, 'W': 4, 'X': 4}"
INV-ZZ-0001072,SCH-ZZ-0000092,1028,Boeing 787,08/24/2024,08/24/2024,DUB,VNS,270,299,127,-143,172,27,54,81,108,31,15,16,59,24,35,89,44,45,120,44,76,"{'F': 16, 'P': 11}","{'C': 22, 'J': 16, 'Z': 16}","{'Q': 24, 'R': 16, 'S': 8, 'T': 8, 'H': 16, 'M': 8}","{'Y': 8, 'A': 8, 'B': 4, 'D': 4, 'E': 4, 'G': 8, 'I': 4, 'K': 8, 'L': 4, 'N': 4, 'O': 4, 'U': 8, 'V': 4, 'W': 4, 'X': 4}"
INV-ZZ-0001136,SCH-ZZ-0000156,1028,Boeing 787,08/24/2024,08/24/2024,DUB,VNS,270,296,167,-103,129,27,54,81,108,29,15,14,57,28,29,91,63,28,119,61,58,"{'F': 16, 'P': 11}","{'C': 22, 'J': 16, 'Z': 16}","{'Q': 24, 'R': 16, 'S': 8, 'T': 8, 'H': 16, 'M': 8}","{'Y': 8, 'A': 8, 'B': 4, 'D': 4, 'E': 4, 'G': 8, 'I': 4, 'K': 8, 'L': 4, 'N': 4, 'O': 4, 'U': 8, 'V': 4, 'W': 4, 'X': 4}"
INV-ZZ-0001009,SCH-ZZ-0000029,1029,Boeing 787,08/24/2024,08/24/2024,DUB,JFK,270,291,178,-92,113,27,54,81,108,31,13,18,55,54,1,90,70,20,115,41,74,"{'F': 16, 'P': 11}","{'C': 22, 'J': 16, 'Z': 16}","{'Q': 24, 'R': 16, 'S': 8, 'T': 8, 'H': 16, 'M': 8}","{'Y': 8, 'A': 8, 'B': 4, 'D': 4, 'E': 4, 'G': 8, 'I': 4, 'K': 8, 'L': 4, 'N': 4, 'O': 4, 'U': 8, 'V': 4, 'W': 4, 'X': 4}"
INV-ZZ-0001073,SCH-ZZ-0000093,1029,Boeing 787,08/24/2024,08/24/2024,DUB,JFK,270,288,124,-146,164,27,54,81,108,28,13,15,55,28,27,82,36,46,123,47,76,"{'F': 16, 'P': 11}","{'C': 22, 'J': 16, 'Z': 16}","{'Q': 24, 'R': 16, 'S': 8, 'T': 8, 'H': 16, 'M': 8}","{'Y': 8, 'A': 8, 'B': 4, 'D': 4, 'E': 4, 'G': 8, 'I': 4, 'K': 8, 'L': 4, 'N': 4, 'O': 4, 'U': 8, 'V': 4, 'W': 4, 'X': 4}"
INV-ZZ-0001137,SCH-ZZ-0000157,1029,Boeing 787,08/24/2024,08/24/2024,DUB,JFK,270,294,215,-55,79,27,54,81,108,30,21,9,60,48,12,91,59,32,113,87,26,"{'F': 16, 'P': 11}","{'C': 22, 'J': 16, 'Z': 16}","{'Q': 24, 'R': 16, 'S': 8, 'T': 8, 'H': 16, 'M': 8}","{'Y': 8, 'A': 8, 'B': 4, 'D': 4, 'E': 4, 'G': 8, 'I': 4, 'K': 8, 'L': 4, 'N': 4, 'O': 4, 'U': 8, 'V': 4, 'W': 4, 'X': 4}"
INV-ZZ-0001010,SCH-ZZ-0000030,1030,Boeing 787,08/24/2024,08/24/2024,DUB,DEL,270,302,186,-84,116,27,54,81,108,32,10,22,59,51,8,87,53,34,124,72,52,"{'F': 16, 'P': 11}","{'C': 22, 'J': 16, 'Z': 16}","{'Q': 24, 'R': 16, 'S': 8, 'T': 8, 'H': 16, 'M': 8}","{'Y': 8, 'A': 8, 'B': 4, 'D': 4, 'E': 4, 'G': 8, 'I': 4, 'K': 8, 'L': 4, 'N': 4, 'O': 4, 'U': 8, 'V': 4, 'W': 4, 'X': 4}"
INV-ZZ-0001074,SCH-ZZ-0000094,1030,Boeing 787,08/24/2024,08/24/2024,DUB,DEL,270,290,219,-51,71,27,54,81,108,31,24,7,56,52,4,88,51,37,115,92,23,"{'F': 16, 'P': 11}","{'C': 22, 'J': 16, 'Z': 16}","{'Q': 24, 'R': 16, 'S': 8, 'T': 8, 'H': 16, 'M': 8}","{'Y': 8, 'A': 8, 'B': 4, 'D': 4, 'E': 4, 'G': 8, 'I': 4, 'K': 8, 'L': 4, 'N': 4, 'O': 4, 'U': 8, 'V': 4, 'W': 4, 'X': 4}"
INV-ZZ-0001138,SCH-ZZ-0000158,1030,Boeing 787,08/24/2024,08/24/2024,DUB,DEL,270,286,190,-80,96,27,54,81,108,32,10,22,56,54,2,82,72,10,116,54,62,"{'F': 16, 'P': 11}","{'C': 22, 'J': 16, 'Z': 16}","{'Q': 24, 'R': 16, 'S': 8, 'T': 8, 'H': 16, 'M': 8}","{'Y': 8, 'A': 8, 'B': 4, 'D': 4, 'E': 4, 'G': 8, 'I': 4, 'K': 8, 'L': 4, 'N': 4, 'O': 4, 'U': 8, 'V': 4, 'W': 4, 'X': 4}"
INV-ZZ-0001011,SCH-ZZ-0000031,1031,Boeing 787,08/24/2024,08/24/2024,DUB,LAX,270,296,186,-84,110,27,54,81,108,30,16,14,57,50,7,88,40,48,121,80,41,"{'F': 16, 'P': 11}","{'C': 22, 'J': 16, 'Z': 16}","{'Q': 24, 'R': 16, 'S': 8, 'T': 8, 'H': 16, 'M': 8}","{'Y': 8, 'A': 8, 'B': 4, 'D': 4, 'E': 4, 'G': 8, 'I': 4, 'K': 8, 'L': 4, 'N': 4, 'O': 4, 'U': 8, 'V': 4, 'W': 4, 'X': 4}"
INV-ZZ-0001075,SCH-ZZ-0000095,1031,Boeing 787,08/24/2024,08/24/2024,DUB,LAX,270,306,149,-121,157,27,54,81,108,28,12,16,60,43,17,91,42,49,127,52,75,"{'F': 16, 'P': 11}","{'C': 22, 'J': 16, 'Z': 16}","{'Q': 24, 'R': 16, 'S': 8, 'T': 8, 'H': 16, 'M': 8}","{'Y': 8, 'A': 8, 'B': 4, 'D': 4, 'E': 4, 'G': 8, 'I': 4, 'K': 8, 'L': 4, 'N': 4, 'O': 4, 'U': 8, 'V': 4, 'W': 4, 'X': 4}"
INV-ZZ-0001139,SCH-ZZ-0000159,1031,Boeing 787,08/24/2024,08/24/2024,DUB,LAX,270,287,155,-115,132,27,54,81,108,31,15,16,57,29,28,84,50,34,115,61,54,"{'F': 16, 'P': 11}","{'C': 22, 'J': 16, 'Z': 16}","{'Q': 24, 'R': 16, 'S': 8, 'T': 8, 'H': 16, 'M': 8}","{'Y': 8, 'A': 8, 'B': 4, 'D': 4, 'E': 4, 'G': 8, 'I': 4, 'K': 8, 'L': 4, 'N': 4, 'O': 4, 'U': 8, 'V': 4, 'W': 4, 'X': 4}"
INV-ZZ-0001012,SCH-ZZ-0000032,1032,Boeing 787,08/24/2024,08/24/2024,VNS,MAA,270,281,213,-57,68,27,54,81,108,30,13,17,57,36,21,85,70,15,109,94,15,"{'F': 16, 'P': 11}","{'C': 22, 'J': 16, 'Z': 16}","{'Q': 24, 'R': 16, 'S': 8, 'T': 8, 'H': 16, 'M': 8}","{'Y': 8, 'A': 8, 'B': 4, 'D': 4, 'E': 4, 'G': 8, 'I': 4, 'K': 8, 'L': 4, 'N': 4, 'O': 4, 'U': 8, 'V': 4, 'W': 4, 'X': 4}"
INV-ZZ-0001076,SCH-ZZ-0000096,1032,Boeing 787,08/24/2024,08/24/2024,VNS,MAA,270,296,212,-58,84,27,54,81,108,29,17,12,55,46,9,86,44,42,126,105,21,"{'F': 16, 'P': 11}","{'C': 22, 'J': 16, 'Z': 16}","{'Q': 24, 'R': 16, 'S': 8, 'T': 8, 'H': 16, 'M': 8}","{'Y': 8, 'A': 8, 'B': 4, 'D': 4, 'E': 4, 'G': 8, 'I': 4, 'K': 8, 'L': 4, 'N': 4, 'O': 4, 'U': 8, 'V': 4, 'W': 4, 'X': 4}"
INV-ZZ-0001140,SCH-ZZ-0000160,1032,Boeing 787,08/24/2024,08/24/2024,VNS,MAA,270,294,180,-90,114,27,54,81,108,28,18,10,57,47,10,84,56,28,125,59,66,"{'F': 16, 'P': 11}","{'C': 22, 'J': 16, 'Z': 16}","{'Q': 24, 'R': 16, 'S': 8, 'T': 8, 'H': 16, 'M': 8}","{'Y': 8, 'A': 8, 'B': 4, 'D': 4, 'E': 4, 'G': 8, 'I': 4, 'K': 8, 'L': 4, 'N': 4, 'O': 4, 'U': 8, 'V': 4, 'W': 4, 'X': 4}"
INV-ZZ-0001013,SCH-ZZ-0000033,1033,Boeing 787,08/24/2024,08/24/2024,VNS,BLR,270,288,137,-133,151,27,54,81,108,30,25,5,56,21,35,90,47,43,112,44,68,"{'F': 16, 'P': 11}","{'C': 22, 'J': 16, 'Z': 16}","{'Q': 24, 'R': 16, 'S': 8, 'T': 8, 'H': 16, 'M': 8}","{'Y': 8, 'A': 8, 'B': 4, 'D': 4, 'E': 4, 'G': 8, 'I': 4, 'K': 8, 'L': 4, 'N': 4, 'O': 4, 'U': 8, 'V': 4, 'W': 4, 'X': 4}"
INV-ZZ-0001077,SCH-ZZ-0000097,1033,Boeing 787,08/24/2024,08/24/2024,VNS,BLR,270,278,155,-115,123,27,54,81,108,28,26,2,56,31,25,84,49,35,110,49,61,"{'F': 16, 'P': 11}","{'C': 22, 'J': 16, 'Z': 16}","{'Q': 24, 'R': 16, 'S': 8, 'T': 8, 'H': 16, 'M': 8}","{'Y': 8, 'A': 8, 'B': 4, 'D': 4, 'E': 4, 'G': 8, 'I': 4, 'K': 8, 'L': 4, 'N': 4, 'O': 4, 'U': 8, 'V': 4, 'W': 4, 'X': 4}"
INV-ZZ-0001141,SCH-ZZ-0000161,1033,Boeing 787,08/24/2024,08/24/2024,VNS,BLR,270,297,142,-128,155,27,54,81,108,31,26,5,60,20,40,82,43,39,124,53,71,"{'F': 16, 'P': 11}","{'C': 22, 'J': 16, 'Z': 16}","{'Q': 24, 'R': 16, 'S': 8, 'T': 8, 'H': 16, 'M': 8}","{'Y': 8, 'A': 8, 'B': 4, 'D': 4, 'E': 4, 'G': 8, 'I': 4, 'K': 8, 'L': 4, 'N': 4, 'O': 4, 'U': 8, 'V': 4, 'W': 4, 'X': 4}"
INV-ZZ-0001014,SCH-ZZ-0000034,1034,Boeing 787,08/24/2024,08/24/2024,VNS,BOM,270,283,174,-96,109,27,54,81,108,29,18,11,55,27,28,89,70,19,110,59,51,"{'F': 16, 'P': 11}","{'C': 22, 'J': 16, 'Z': 16}","{'Q': 24, 'R': 16, 'S': 8, 'T': 8, 'H': 16, 'M': 8}","{'Y': 8, 'A': 8, 'B': 4, 'D': 4, 'E': 4, 'G': 8, 'I': 4, 'K': 8, 'L': 4, 'N': 4, 'O': 4, 'U': 8, 'V': 4, 'W': 4, 'X': 4}"
INV-ZZ-0001078,SCH-ZZ-0000098,1034,Boeing 787,08/24/2024,08/24/2024,VNS,BOM,270,289,198,-72,91,27,54,81,108,31,14,17,58,25,33,89,53,36,111,106,5,"{'F': 16, 'P': 11}","{'C': 22, 'J': 16, 'Z': 16}","{'Q': 24, 'R': 16, 'S': 8, 'T': 8, 'H': 16, 'M': 8}","{'Y': 8, 'A': 8, 'B': 4, 'D': 4, 'E': 4, 'G': 8, 'I': 4, 'K': 8, 'L': 4, 'N': 4, 'O': 4, 'U': 8, 'V': 4, 'W': 4, 'X': 4}"
INV-ZZ-0001142,SCH-ZZ-0000162,1034,Boeing 787,08/24/2024,08/24/2024,VNS,BOM,270,281,166,-104,115,27,54,81,108,29,22,7,55,41,14,84,38,46,113,65,48,"{'F': 16, 'P': 11}","{'C': 22, 'J': 16, 'Z': 16}","{'Q': 24, 'R': 16, 'S': 8, 'T': 8, 'H': 16, 'M': 8}","{'Y': 8, 'A': 8, 'B': 4, 'D': 4, 'E': 4, 'G': 8, 'I': 4, 'K': 8, 'L': 4, 'N': 4, 'O': 4, 'U': 8, 'V': 4, 'W': 4, 'X': 4}"
INV-ZZ-0001015,SCH-ZZ-0000035,1035,Boeing 787,08/24/2024,08/24/2024,VNS,DUB,270,296,197,-73,99,27,54,81,108,30,18,12,57,20,37,90,73,17,119,86,33,"{'F': 16, 'P': 11}","{'C': 22, 'J': 16, 'Z': 16}","{'Q': 24, 'R': 16, 'S': 8, 'T': 8, 'H': 16, 'M': 8}","{'Y': 8, 'A': 8, 'B': 4, 'D': 4, 'E': 4, 'G': 8, 'I': 4, 'K': 8, 'L': 4, 'N': 4, 'O': 4, 'U': 8, 'V': 4, 'W': 4, 'X': 4}"
INV-ZZ-0001079,SCH-ZZ-0000099,1035,Boeing 787,08/24/2024,08/24/2024,VNS,DUB,270,290,156,-114,134,27,54,81,108,31,13,18,55,54,1,85,46,39,119,43,76,"{'F': 16, 'P': 11}","{'C': 22, 'J': 16, 'Z': 16}","{'Q': 24, 'R': 16, 'S': 8, 'T': 8, 'H': 16, 'M': 8}","{'Y': 8, 'A': 8, 'B': 4, 'D': 4, 'E': 4, 'G': 8, 'I': 4, 'K': 8, 'L': 4, 'N': 4, 'O': 4, 'U': 8, 'V': 4, 'W': 4, 'X': 4}"
INV-ZZ-0001143,SCH-ZZ-0000163,1035,Boeing 787,08/24/2024,08/24/2024,VNS,DUB,270,294,166,-104,128,27,54,81,108,32,15,17,56,37,19,82,49,33,124,65,59,"{'F': 16, 'P': 11}","{'C': 22, 'J': 16, 'Z': 16}","{'Q': 24, 'R': 16, 'S': 8, 'T': 8, 'H': 16, 'M': 8}","{'Y': 8, 'A': 8, 'B': 4, 'D': 4, 'E': 4, 'G': 8, 'I': 4, 'K': 8, 'L': 4, 'N': 4, 'O': 4, 'U': 8, 'V': 4, 'W': 4, 'X': 4}"
INV-ZZ-0001017,SCH-ZZ-0000037,1037,Boeing 787,08/24/2024,08/24/2024,VNS,JFK,270,289,161,-109,128,27,54,81,108,29,10,19,56,31,25,89,55,34,115,65,50,"{'F': 16, 'P': 11}","{'C': 22, 'J': 16, 'Z': 16}","{'Q': 24, 'R': 16, 'S': 8, 'T': 8, 'H': 16, 'M': 8}","{'Y': 8, 'A': 8, 'B': 4, 'D': 4, 'E': 4, 'G': 8, 'I': 4, 'K': 8, 'L': 4, 'N': 4, 'O': 4, 'U': 8, 'V': 4, 'W': 4, 'X': 4}"
INV-ZZ-0001081,SCH-ZZ-0000101,1037,Boeing 787,08/24/2024,08/24/2024,VNS,JFK,270,285,194,-76,91,27,54,81,108,29,13,16,59,26,33,87,50,37,110,105,5,"{'F': 16, 'P': 11}","{'C': 22, 'J': 16, 'Z': 16}","{'Q': 24, 'R': 16, 'S': 8, 'T': 8, 'H': 16, 'M': 8}","{'Y': 8, 'A': 8, 'B': 4, 'D': 4, 'E': 4, 'G': 8, 'I': 4, 'K': 8, 'L': 4, 'N': 4, 'O': 4, 'U': 8, 'V': 4, 'W': 4, 'X': 4}"
INV-ZZ-0001145,SCH-ZZ-0000165,1037,Boeing 787,08/24/2024,08/24/2024,VNS,JFK,270,303,146,-124,157,27,54,81,108,30,23,7,61,31,30,88,52,36,124,40,84,"{'F': 16, 'P': 11}","{'C': 22, 'J': 16, 'Z': 16}","{'Q': 24, 'R': 16, 'S': 8, 'T': 8, 'H': 16, 'M': 8}","{'Y': 8, 'A': 8, 'B': 4, 'D': 4, 'E': 4, 'G': 8, 'I': 4, 'K': 8, 'L': 4, 'N': 4, 'O': 4, 'U': 8, 'V': 4, 'W': 4, 'X': 4}"
INV-ZZ-0001018,SCH-ZZ-0000038,1038,Boeing 787,08/24/2024,08/24/2024,VNS,DEL,270,292,166,-104,126,27,54,81,108,31,11,20,59,41,18,90,63,27,112,51,61,"{'F': 16, 'P': 11}","{'C': 22, 'J': 16, 'Z': 16}","{'Q': 24, 'R': 16, 'S': 8, 'T': 8, 'H': 16, 'M': 8}","{'Y': 8, 'A': 8, 'B': 4, 'D': 4, 'E': 4, 'G': 8, 'I': 4, 'K': 8, 'L': 4, 'N': 4, 'O': 4, 'U': 8, 'V': 4, 'W': 4, 'X': 4}"
INV-ZZ-0001082,SCH-ZZ-0000102,1038,Boeing 787,08/24/2024,08/24/2024,VNS,DEL,270,293,165,-105,128,27,54,81,108,32,22,10,57,37,20,82,41,41,122,65,57,"{'F': 16, 'P': 11}","{'C': 22, 'J': 16, 'Z': 16}","{'Q': 24, 'R': 16, 'S': 8, 'T': 8, 'H': 16, 'M': 8}","{'Y': 8, 'A': 8, 'B': 4, 'D': 4, 'E': 4, 'G': 8, 'I': 4, 'K': 8, 'L': 4, 'N': 4, 'O': 4, 'U': 8, 'V': 4, 'W': 4, 'X': 4}"
INV-ZZ-0001146,SCH-ZZ-0000166,1038,Boeing 787,08/24/2024,08/24/2024,VNS,DEL,270,302,217,-53,85,27,54,81,108,29,21,8,56,27,29,90,67,23,127,102,25,"{'F': 16, 'P': 11}","{'C': 22, 'J': 16, 'Z': 16}","{'Q': 24, 'R': 16, 'S': 8, 'T': 8, 'H': 16, 'M': 8}","{'Y': 8, 'A': 8, 'B': 4, 'D': 4, 'E': 4, 'G': 8, 'I': 4, 'K': 8, 'L': 4, 'N': 4, 'O': 4, 'U': 8, 'V': 4, 'W': 4, 'X': 4}"
INV-ZZ-0001019,SCH-ZZ-0000039,1039,Boeing 787,08/24/2024,08/24/2024,VNS,LAX,270,301,169,-101,132,27,54,81,108,28,25,3,55,30,25,90,62,28,128,52,76,"{'F': 16, 'P': 11}","{'C': 22, 'J': 16, 'Z': 16}","{'Q': 24, 'R': 16, 'S': 8, 'T': 8, 'H': 16, 'M': 8}","{'Y': 8, 'A': 8, 'B': 4, 'D': 4, 'E': 4, 'G': 8, 'I': 4, 'K': 8, 'L': 4, 'N': 4, 'O': 4, 'U': 8, 'V': 4, 'W': 4, 'X': 4}"
INV-ZZ-0001083,SCH-ZZ-0000103,1039,Boeing 787,08/24/2024,08/24/2024,VNS,LAX,270,282,153,-117,129,27,54,81,108,29,11,18,55,39,16,83,38,45,115,65,50,"{'F': 16, 'P': 11}","{'C': 22, 'J': 16, 'Z': 16}","{'Q': 24, 'R': 16, 'S': 8, 'T': 8, 'H': 16, 'M': 8}","{'Y': 8, 'A': 8, 'B': 4, 'D': 4, 'E': 4, 'G': 8, 'I': 4, 'K': 8, 'L': 4, 'N': 4, 'O': 4, 'U': 8, 'V': 4, 'W': 4, 'X': 4}"
INV-ZZ-0001147,SCH-ZZ-0000167,1039,Boeing 787,08/24/2024,08/24/2024,VNS,LAX,270,305,200,-70,105,27,54,81,108,32,17,15,61,26,35,84,63,21,128,94,34,"{'F': 16, 'P': 11}","{'C': 22, 'J': 16, 'Z': 16}","{'Q': 24, 'R': 16, 'S': 8, 'T': 8, 'H': 16, 'M': 8}","{'Y': 8, 'A': 8, 'B': 4, 'D': 4, 'E': 4, 'G': 8, 'I': 4, 'K': 8, 'L': 4, 'N': 4, 'O': 4, 'U': 8, 'V': 4, 'W': 4, 'X': 4}"
INV-ZZ-0001020,SCH-ZZ-0000040,1040,Boeing 787,08/24/2024,08/24/2024,JFK,MAA,270,302,150,-120,152,27,54,81,108,31,10,21,56,33,23,90,46,44,125,61,64,"{'F': 16, 'P': 11}","{'C': 22, 'J': 16, 'Z': 16}","{'Q': 24, 'R': 16, 'S': 8, 'T': 8, 'H': 16, 'M': 8}","{'Y': 8, 'A': 8, 'B': 4, 'D': 4, 'E': 4, 'G': 8, 'I': 4, 'K': 8, 'L': 4, 'N': 4, 'O': 4, 'U': 8, 'V': 4, 'W': 4, 'X': 4}"
INV-ZZ-0001084,SCH-ZZ-0000104,1040,Boeing 787,08/24/2024,08/24/2024,JFK,MAA,270,301,158,-112,143,27,54,81,108,28,18,10,59,28,31,89,40,49,125,72,53,"{'F': 16, 'P': 11}","{'C': 22, 'J': 16, 'Z': 16}","{'Q': 24, 'R': 16, 'S': 8, 'T': 8, 'H': 16, 'M': 8}","{'Y': 8, 'A': 8, 'B': 4, 'D': 4, 'E': 4, 'G': 8, 'I': 4, 'K': 8, 'L': 4, 'N': 4, 'O': 4, 'U': 8, 'V': 4, 'W': 4, 'X': 4}"
INV-ZZ-0001148,SCH-ZZ-0000168,1040,Boeing 787,08/24/2024,08/24/2024,JFK,MAA,270,305,196,-74,109,27,54,81,108,32,25,7,56,42,14,91,38,53,126,91,35,"{'F': 16, 'P': 11}","{'C': 22, 'J': 16, 'Z': 16}","{'Q': 24, 'R': 16, 'S': 8, 'T': 8, 'H': 16, 'M': 8}","{'Y': 8, 'A': 8, 'B': 4, 'D': 4, 'E': 4, 'G': 8, 'I': 4, 'K': 8, 'L': 4, 'N': 4, 'O': 4, 'U': 8, 'V': 4, 'W': 4, 'X': 4}"
INV-ZZ-0001021,SCH-ZZ-0000041,1041,Boeing 787,08/24/2024,08/24/2024,JFK,BLR,270,294,191,-79,103,27,54,81,108,32,11,21,60,54,6,91,56,35,111,70,41,"{'F': 16, 'P': 11}","{'C': 22, 'J': 16, 'Z': 16}","{'Q': 24, 'R': 16, 'S': 8, 'T': 8, 'H': 16, 'M': 8}","{'Y': 8, 'A': 8, 'B': 4, 'D': 4, 'E': 4, 'G': 8, 'I': 4, 'K': 8, 'L': 4, 'N': 4, 'O': 4, 'U': 8, 'V': 4, 'W': 4, 'X': 4}"
INV-ZZ-0001085,SCH-ZZ-0000105,1041,Boeing 787,08/24/2024,08/24/2024,JFK,BLR,270,296,165,-105,131,27,54,81,108,28,21,7,61,22,39,82,38,44,125,84,41,"{'F': 16, 'P': 11}","{'C': 22, 'J': 16, 'Z': 16}","{'Q': 24, 'R': 16, 'S': 8, 'T': 8, 'H': 16, 'M': 8}","{'Y': 8, 'A': 8, 'B': 4, 'D': 4, 'E': 4, 'G': 8, 'I': 4, 'K': 8, 'L': 4, 'N': 4, 'O': 4, 'U': 8, 'V': 4, 'W': 4, 'X': 4}"
INV-ZZ-0001149,SCH-ZZ-0000169,1041,Boeing 787,08/24/2024,08/24/2024,JFK,BLR,270,292,197,-73,95,27,54,81,108,31,18,13,60,49,11,88,67,21,113,63,50,"{'F': 16, 'P': 11}","{'C': 22, 'J': 16, 'Z': 16}","{'Q': 24, 'R': 16, 'S': 8, 'T': 8, 'H': 16, 'M': 8}","{'Y': 8, 'A': 8, 'B': 4, 'D': 4, 'E': 4, 'G': 8, 'I': 4, 'K': 8, 'L': 4, 'N': 4, 'O': 4, 'U': 8, 'V': 4, 'W': 4, 'X': 4}"
INV-ZZ-0001022,SCH-ZZ-0000042,1042,Boeing 787,08/24/2024,08/24/2024,JFK,BOM,270,296,171,-99,125,27,54,81,108,31,19,12,58,42,16,87,35,52,120,75,45,"{'F': 16, 'P': 11}","{'C': 22, 'J': 16, 'Z': 16}","{'Q': 24, 'R': 16, 'S': 8, 'T': 8, 'H': 16, 'M': 8}","{'Y': 8, 'A': 8, 'B': 4, 'D': 4, 'E': 4, 'G': 8, 'I': 4, 'K': 8, 'L': 4, 'N': 4, 'O': 4, 'U': 8, 'V': 4, 'W': 4, 'X': 4}"
INV-ZZ-0001086,SCH-ZZ-0000106,1042,Boeing 787,08/24/2024,08/24/2024,JFK,BOM,270,286,184,-86,102,27,54,81,108,31,10,21,59,53,6,82,54,28,114,67,47,"{'F': 16, 'P': 11}","{'C': 22, 'J': 16, 'Z': 16}","{'Q': 24, 'R': 16, 'S': 8, 'T': 8, 'H': 16, 'M': 8}","{'Y': 8, 'A': 8, 'B': 4, 'D': 4, 'E': 4, 'G': 8, 'I': 4, 'K': 8, 'L': 4, 'N': 4, 'O': 4, 'U': 8, 'V': 4, 'W': 4, 'X': 4}"
INV-ZZ-0001150,SCH-ZZ-0000170,1042,Boeing 787,08/24/2024,08/24/2024,JFK,BOM,270,295,157,-113,138,27,54,81,108,28,22,6,61,35,26,90,45,45,116,55,61,"{'F': 16, 'P': 11}","{'C': 22, 'J': 16, 'Z': 16}","{'Q': 24, 'R': 16, 'S': 8, 'T': 8, 'H': 16, 'M': 8}","{'Y': 8, 'A': 8, 'B': 4, 'D': 4, 'E': 4, 'G': 8, 'I': 4, 'K': 8, 'L': 4, 'N': 4, 'O': 4, 'U': 8, 'V': 4, 'W': 4, 'X': 4}"
INV-ZZ-0001023,SCH-ZZ-0000043,1043,Boeing 787,08/24/2024,08/24/2024,JFK,DUB,270,306,205,-65,101,27,54,81,108,31,27,4,60,40,20,87,64,23,128,74,54,"{'F': 16, 'P': 11}","{'C': 22, 'J': 16, 'Z': 16}","{'Q': 24, 'R': 16, 'S': 8, 'T': 8, 'H': 16, 'M': 8}","{'Y': 8, 'A': 8, 'B': 4, 'D': 4, 'E': 4, 'G': 8, 'I': 4, 'K': 8, 'L': 4, 'N': 4, 'O': 4, 'U': 8, 'V': 4, 'W': 4, 'X': 4}"
INV-ZZ-0001087,SCH-ZZ-0000107,1043,Boeing 787,08/24/2024,08/24/2024,JFK,DUB,270,299,165,-105,134,27,54,81,108,28,21,7,55,31,24,89,69,20,127,44,83,"{'F': 16, 'P': 11}","{'C': 22, 'J': 16, 'Z': 16}","{'Q': 24, 'R': 16, 'S': 8, 'T': 8, 'H': 16, 'M': 8}","{'Y': 8, 'A': 8, 'B': 4, 'D': 4, 'E': 4, 'G': 8, 'I': 4, 'K': 8, 'L': 4, 'N': 4, 'O': 4, 'U': 8, 'V': 4, 'W': 4, 'X': 4}"
INV-ZZ-0001151,SCH-ZZ-0000171,1043,Boeing 787,08/24/2024,08/24/2024,JFK,DUB,270,302,194,-76,108,27,54,81,108,30,20,10,61,37,24,87,42,45,124,95,29,"{'F': 16, 'P': 11}","{'C': 22, 'J': 16, 'Z': 16}","{'Q': 24, 'R': 16, 'S': 8, 'T': 8, 'H': 16, 'M': 8}","{'Y': 8, 'A': 8, 'B': 4, 'D': 4, 'E': 4, 'G': 8, 'I': 4, 'K': 8, 'L': 4, 'N': 4, 'O': 4, 'U': 8, 'V': 4, 'W': 4, 'X': 4}"
INV-ZZ-0001024,SCH-ZZ-0000044,1044,Boeing 787,08/24/2024,08/24/2024,JFK,VNS,270,297,193,-77,104,27,54,81,108,32,26,6,60,27,33,87,59,28,118,81,37,"{'F': 16, 'P': 11}","{'C': 22, 'J': 16, 'Z': 16}","{'Q': 24, 'R': 16, 'S': 8, 'T': 8, 'H': 16, 'M': 8}","{'Y': 8, 'A': 8, 'B': 4, 'D': 4, 'E': 4, 'G': 8, 'I': 4, 'K': 8, 'L': 4, 'N': 4, 'O': 4, 'U': 8, 'V': 4, 'W': 4, 'X': 4}"
INV-ZZ-0001088,SCH-ZZ-0000108,1044,Boeing 787,08/24/2024,08/24/2024,JFK,VNS,270,301,215,-55,86,27,54,81,108,31,23,8,61,45,16,87,72,15,122,75,47,"{'F': 16, 'P': 11}","{'C': 22, 'J': 16, 'Z': 16}","{'Q': 24, 'R': 16, 'S': 8, 'T': 8, 'H': 16, 'M': 8}","{'Y': 8, 'A': 8, 'B': 4, 'D': 4, 'E': 4, 'G': 8, 'I': 4, 'K': 8, 'L': 4, 'N': 4, 'O': 4, 'U': 8, 'V': 4, 'W': 4, 'X': 4}"
INV-ZZ-0001152,SCH-ZZ-0000172,1044,Boeing 787,08/24/2024,08/24/2024,JFK,VNS,270,295,179,-91,116,27,54,81,108,28,11,17,60,47,13,91,65,26,116,56,60,"{'F': 16, 'P': 11}","{'C': 22, 'J': 16, 'Z': 16}","{'Q': 24, 'R': 16, 'S': 8, 'T': 8, 'H': 16, 'M': 8}","{'Y': 8, 'A': 8, 'B': 4, 'D': 4, 'E': 4, 'G': 8, 'I': 4, 'K': 8, 'L': 4, 'N': 4, 'O': 4, 'U': 8, 'V': 4, 'W': 4, 'X': 4}"
INV-ZZ-0001026,SCH-ZZ-0000046,1046,Boeing 787,08/24/2024,08/24/2024,JFK,DEL,270,287,223,-47,64,27,54,81,108,32,15,17,60,51,9,83,70,13,112,87,25,"{'F': 16, 'P': 11}","{'C': 22, 'J': 16, 'Z': 16}","{'Q': 24, 'R': 16, 'S': 8, 'T': 8, 'H': 16, 'M': 8}","{'Y': 8, 'A': 8, 'B': 4, 'D': 4, 'E': 4, 'G': 8, 'I': 4, 'K': 8, 'L': 4, 'N': 4, 'O': 4, 'U': 8, 'V': 4, 'W': 4, 'X': 4}"
INV-ZZ-0001090,SCH-ZZ-0000110,1046,Boeing 787,08/24/2024,08/24/2024,JFK,DEL,270,283,188,-82,95,27,54,81,108,30,22,8,58,20,38,84,72,12,111,74,37,"{'F': 16, 'P': 11}","{'C': 22, 'J': 16, 'Z': 16}","{'Q': 24, 'R': 16, 'S': 8, 'T': 8, 'H': 16, 'M': 8}","{'Y': 8, 'A': 8, 'B': 4, 'D': 4, 'E': 4, 'G': 8, 'I': 4, 'K': 8, 'L': 4, 'N': 4, 'O': 4, 'U': 8, 'V': 4, 'W': 4, 'X': 4}"
INV-ZZ-0001154,SCH-ZZ-0000174,1046,Boeing 787,08/24/2024,08/24/2024,JFK,DEL,270,293,206,-64,87,27,54,81,108,28,19,9,56,28,28,87,61,26,122,98,24,"{'F': 16, 'P': 11}","{'C': 22, 'J': 16, 'Z': 16}","{'Q': 24, 'R': 16, 'S': 8, 'T': 8, 'H': 16, 'M': 8}","{'Y': 8, 'A': 8, 'B': 4, 'D': 4, 'E': 4, 'G': 8, 'I': 4, 'K': 8, 'L': 4, 'N': 4, 'O': 4, 'U': 8, 'V': 4, 'W': 4, 'X': 4}"
INV-ZZ-0001027,SCH-ZZ-0000047,1047,Boeing 787,08/24/2024,08/24/2024,JFK,LAX,270,298,221,-49,77,27,54,81,108,29,17,12,56,43,13,86,55,31,127,106,21,"{'F': 16, 'P': 11}","{'C': 22, 'J': 16, 'Z': 16}","{'Q': 24, 'R': 16, 'S': 8, 'T': 8, 'H': 16, 'M': 8}","{'Y': 8, 'A': 8, 'B': 4, 'D': 4, 'E': 4, 'G': 8, 'I': 4, 'K': 8, 'L': 4, 'N': 4, 'O': 4, 'U': 8, 'V': 4, 'W': 4, 'X': 4}"
INV-ZZ-0001091,SCH-ZZ-0000111,1047,Boeing 787,08/24/2024,08/24/2024,JFK,LAX,270,291,220,-50,71,27,54,81,108,29,18,11,55,24,31,89,77,12,118,101,17,"{'F': 16, 'P': 11}","{'C': 22, 'J': 16, 'Z': 16}","{'Q': 24, 'R': 16, 'S': 8, 'T': 8, 'H': 16, 'M': 8}","{'Y': 8, 'A': 8, 'B': 4, 'D': 4, 'E': 4, 'G': 8, 'I': 4, 'K': 8, 'L': 4, 'N': 4, 'O': 4, 'U': 8, 'V': 4, 'W': 4, 'X': 4}"
INV-ZZ-0001155,SCH-ZZ-0000175,1047,Boeing 787,08/24/2024,08/24/2024,JFK,LAX,270,296,187,-83,109,27,54,81,108,29,11,18,61,21,40,91,59,32,115,96,19,"{'F': 16, 'P': 11}","{'C': 22, 'J': 16, 'Z': 16}","{'Q': 24, 'R': 16, 'S': 8, 'T': 8, 'H': 16, 'M': 8}","{'Y': 8, 'A': 8, 'B': 4, 'D': 4, 'E': 4, 'G': 8, 'I': 4, 'K': 8, 'L': 4, 'N': 4, 'O': 4, 'U': 8, 'V': 4, 'W': 4, 'X': 4}"
INV-ZZ-0001028,SCH-ZZ-0000048,1048,Boeing 787,08/24/2024,08/24/2024,DEL,MAA,270,292,215,-55,77,27,54,81,108,30,14,16,59,36,23,84,62,22,119,103,16,"{'F': 16, 'P': 11}","{'C': 22, 'J': 16, 'Z': 16}","{'Q': 24, 'R': 16, 'S': 8, 'T': 8, 'H': 16, 'M': 8}","{'Y': 8, 'A': 8, 'B': 4, 'D': 4, 'E': 4, 'G': 8, 'I': 4, 'K': 8, 'L': 4, 'N': 4, 'O': 4, 'U': 8, 'V': 4, 'W': 4, 'X': 4}"
INV-ZZ-0001092,SCH-ZZ-0000112,1048,Boeing 787,08/24/2024,08/24/2024,DEL,MAA,270,296,209,-61,87,27,54,81,108,32,27,5,57,32,25,89,46,43,118,104,14,"{'F': 16, 'P': 11}","{'C': 22, 'J': 16, 'Z': 16}","{'Q': 24, 'R': 16, 'S': 8, 'T': 8, 'H': 16, 'M': 8}","{'Y': 8, 'A': 8, 'B': 4, 'D': 4, 'E': 4, 'G': 8, 'I': 4, 'K': 8, 'L': 4, 'N': 4, 'O': 4, 'U': 8, 'V': 4, 'W': 4, 'X': 4}"
INV-ZZ-0001156,SCH-ZZ-0000176,1048,Boeing 787,08/24/2024,08/24/2024,DEL,MAA,270,294,205,-65,89,27,54,81,108,28,17,11,61,38,23,86,49,37,119,101,18,"{'F': 16, 'P': 11}","{'C': 22, 'J': 16, 'Z': 16}","{'Q': 24, 'R': 16, 'S': 8, 'T': 8, 'H': 16, 'M': 8}","{'Y': 8, 'A': 8, 'B': 4, 'D': 4, 'E': 4, 'G': 8, 'I': 4, 'K': 8, 'L': 4, 'N': 4, 'O': 4, 'U': 8, 'V': 4, 'W': 4, 'X': 4}"
INV-ZZ-0001029,SCH-ZZ-0000049,1049,Boeing 787,08/24/2024,08/24/2024,DEL,BLR,270,307,217,-53,90,27,54,81,108,30,24,6,61,43,18,89,75,14,127,75,52,"{'F': 16, 'P': 11}","{'C': 22, 'J': 16, 'Z': 16}","{'Q': 24, 'R': 16, 'S': 8, 'T': 8, 'H': 16, 'M': 8}","{'Y': 8, 'A': 8, 'B': 4, 'D': 4, 'E': 4, 'G': 8, 'I': 4, 'K': 8, 'L': 4, 'N': 4, 'O': 4, 'U': 8, 'V': 4, 'W': 4, 'X': 4}"
INV-ZZ-0001093,SCH-ZZ-0000113,1049,Boeing 787,08/24/2024,08/24/2024,DEL,BLR,270,292,193,-77,99,27,54,81,108,32,21,11,55,50,5,87,69,18,118,53,65,"{'F': 16, 'P': 11}","{'C': 22, 'J': 16, 'Z': 16}","{'Q': 24, 'R': 16, 'S': 8, 'T': 8, 'H': 16, 'M': 8}","{'Y': 8, 'A': 8, 'B': 4, 'D': 4, 'E': 4, 'G': 8, 'I': 4, 'K': 8, 'L': 4, 'N': 4, 'O': 4, 'U': 8, 'V': 4, 'W': 4, 'X': 4}"
INV-ZZ-0001157,SCH-ZZ-0000177,1049,Boeing 787,08/24/2024,08/24/2024,DEL,BLR,270,295,153,-117,142,27,54,81,108,28,13,15,56,41,15,90,42,48,121,57,64,"{'F': 16, 'P': 11}","{'C': 22, 'J': 16, 'Z': 16}","{'Q': 24, 'R': 16, 'S': 8, 'T': 8, 'H': 16, 'M': 8}","{'Y': 8, 'A': 8, 'B': 4, 'D': 4, 'E': 4, 'G': 8, 'I': 4, 'K': 8, 'L': 4, 'N': 4, 'O': 4, 'U': 8, 'V': 4, 'W': 4, 'X': 4}"
INV-ZZ-0001030,SCH-ZZ-0000050,1050,Boeing 787,08/24/2024,08/24/2024,DEL,BOM,270,288,164,-106,124,27,54,81,108,29,12,17,58,31,27,90,35,55,111,86,25,"{'F': 16, 'P': 11}","{'C': 22, 'J': 16, 'Z': 16}","{'Q': 24, 'R': 16, 'S': 8, 'T': 8, 'H': 16, 'M': 8}","{'Y': 8, 'A': 8, 'B': 4, 'D': 4, 'E': 4, 'G': 8, 'I': 4, 'K': 8, 'L': 4, 'N': 4, 'O': 4, 'U': 8, 'V': 4, 'W': 4, 'X': 4}"
INV-ZZ-0001094,SCH-ZZ-0000114,1050,Boeing 787,08/24/2024,08/24/2024,DEL,BOM,270,295,184,-86,111,27,54,81,108,28,13,15,56,25,31,91,42,49,120,104,16,"{'F': 16, 'P': 11}","{'C': 22, 'J': 16, 'Z': 16}","{'Q': 24, 'R': 16, 'S': 8, 'T': 8, 'H': 16, 'M': 8}","{'Y': 8, 'A': 8, 'B': 4, 'D': 4, 'E': 4, 'G': 8, 'I': 4, 'K': 8, 'L': 4, 'N': 4, 'O': 4, 'U': 8, 'V': 4, 'W': 4, 'X': 4}"
INV-ZZ-0001158,SCH-ZZ-0000178,1050,Boeing 787,08/24/2024,08/24/2024,DEL,BOM,270,292,225,-45,67,27,54,81,108,31,23,8,57,38,19,90,58,32,114,106,8,"{'F': 16, 'P': 11}","{'C': 22, 'J': 16, 'Z': 16}","{'Q': 24, 'R': 16, 'S': 8, 'T': 8, 'H': 16, 'M': 8}","{'Y': 8, 'A': 8, 'B': 4, 'D': 4, 'E': 4, 'G': 8, 'I': 4, 'K': 8, 'L': 4, 'N': 4, 'O': 4, 'U': 8, 'V': 4, 'W': 4, 'X': 4}"
INV-ZZ-0001031,SCH-ZZ-0000051,1051,Boeing 787,08/24/2024,08/24/2024,DEL,DUB,270,284,184,-86,100,27,54,81,108,28,24,4,55,41,14,85,57,28,116,62,54,"{'F': 16, 'P': 11}","{'C': 22, 'J': 16, 'Z': 16}","{'Q': 24, 'R': 16, 'S': 8, 'T': 8, 'H': 16, 'M': 8}","{'Y': 8, 'A': 8, 'B': 4, 'D': 4, 'E': 4, 'G': 8, 'I': 4, 'K': 8, 'L': 4, 'N': 4, 'O': 4, 'U': 8, 'V': 4, 'W': 4, 'X': 4}"
INV-ZZ-0001095,SCH-ZZ-0000115,1051,Boeing 787,08/24/2024,08/24/2024,DEL,DUB,270,303,195,-75,108,27,54,81,108,31,12,19,58,37,21,89,62,27,125,84,41,"{'F': 16, 'P': 11}","{'C': 22, 'J': 16, 'Z': 16}","{'Q': 24, 'R': 16, 'S': 8, 'T': 8, 'H': 16, 'M': 8}","{'Y': 8, 'A': 8, 'B': 4, 'D': 4, 'E': 4, 'G': 8, 'I': 4, 'K': 8, 'L': 4, 'N': 4, 'O': 4, 'U': 8, 'V': 4, 'W': 4, 'X': 4}"
INV-ZZ-0001159,SCH-ZZ-0000179,1051,Boeing 787,08/24/2024,08/24/2024,DEL,DUB,270,307,144,-126,163,27,54,81,108,28,12,16,60,24,36,91,48,43,128,60,68,"{'F': 16, 'P': 11}","{'C': 22, 'J': 16, 'Z': 16}","{'Q': 24, 'R': 16, 'S': 8, 'T': 8, 'H': 16, 'M': 8}","{'Y': 8, 'A': 8, 'B': 4, 'D': 4, 'E': 4, 'G': 8, 'I': 4, 'K': 8, 'L': 4, 'N': 4, 'O': 4, 'U': 8, 'V': 4, 'W': 4, 'X': 4}"
INV-ZZ-0001032,SCH-ZZ-0000052,1052,Boeing 787,08/24/2024,08/24/2024,DEL,VNS,270,288,200,-70,88,27,54,81,108,29,10,19,57,46,11,86,42,44,116,102,14,"{'F': 16, 'P': 11}","{'C': 22, 'J': 16, 'Z': 16}","{'Q': 24, 'R': 16, 'S': 8, 'T': 8, 'H': 16, 'M': 8}","{'Y': 8, 'A': 8, 'B': 4, 'D': 4, 'E': 4, 'G': 8, 'I': 4, 'K': 8, 'L': 4, 'N': 4, 'O': 4, 'U': 8, 'V': 4, 'W': 4, 'X': 4}"
INV-ZZ-0001096,SCH-ZZ-0000116,1052,Boeing 787,08/24/2024,08/24/2024,DEL,VNS,270,295,152,-118,143,27,54,81,108,29,27,2,57,27,30,85,55,30,124,43,81,"{'F': 16, 'P': 11}","{'C': 22, 'J': 16, 'Z': 16}","{'Q': 24, 'R': 16, 'S': 8, 'T': 8, 'H': 16, 'M': 8}","{'Y': 8, 'A': 8, 'B': 4, 'D': 4, 'E': 4, 'G': 8, 'I': 4, 'K': 8, 'L': 4, 'N': 4, 'O': 4, 'U': 8, 'V': 4, 'W': 4, 'X': 4}"
INV-ZZ-0001160,SCH-ZZ-0000180,1052,Boeing 787,08/24/2024,08/24/2024,DEL,VNS,270,297,176,-94,121,27,54,81,108,30,21,9,61,36,25,82,39,43,124,80,44,"{'F': 16, 'P': 11}","{'C': 22, 'J': 16, 'Z': 16}","{'Q': 24, 'R': 16, 'S': 8, 'T': 8, 'H': 16, 'M': 8}","{'Y': 8, 'A': 8, 'B': 4, 'D': 4, 'E': 4, 'G': 8, 'I': 4, 'K': 8, 'L': 4, 'N': 4, 'O': 4, 'U': 8, 'V': 4, 'W': 4, 'X': 4}"
INV-ZZ-0001033,SCH-ZZ-0000053,1053,Boeing 787,08/24/2024,08/24/2024,DEL,JFK,270,298,234,-36,64,27,54,81,108,32,26,6,61,52,9,82,73,9,123,83,40,"{'F': 16, 'P': 11}","{'C': 22, 'J': 16, 'Z': 16}","{'Q': 24, 'R': 16, 'S': 8, 'T': 8, 'H': 16, 'M': 8}","{'Y': 8, 'A': 8, 'B': 4, 'D': 4, 'E': 4, 'G': 8, 'I': 4, 'K': 8, 'L': 4, 'N': 4, 'O': 4, 'U': 8, 'V': 4, 'W': 4, 'X': 4}"
INV-ZZ-0001097,SCH-ZZ-0000117,1053,Boeing 787,08/24/2024,08/24/2024,DEL,JFK,270,286,199,-71,87,27,54,81,108,30,27,3,56,35,21,89,70,19,111,67,44,"{'F': 16, 'P': 11}","{'C': 22, 'J': 16, 'Z': 16}","{'Q': 24, 'R': 16, 'S': 8, 'T': 8, 'H': 16, 'M': 8}","{'Y': 8, 'A': 8, 'B': 4, 'D': 4, 'E': 4, 'G': 8, 'I': 4, 'K': 8, 'L': 4, 'N': 4, 'O': 4, 'U': 8, 'V': 4, 'W': 4, 'X': 4}"
INV-ZZ-0001161,SCH-ZZ-0000181,1053,Boeing 787,08/24/2024,08/24/2024,DEL,JFK,270,300,198,-72,102,27,54,81,108,28,22,6,59,49,10,90,38,52,123,89,34,"{'F': 16, 'P': 11}","{'C': 22, 'J': 16, 'Z': 16}","{'Q': 24, 'R': 16, 'S': 8, 'T': 8, 'H': 16, 'M': 8}","{'Y': 8, 'A': 8, 'B': 4, 'D': 4, 'E': 4, 'G': 8, 'I': 4, 'K': 8, 'L': 4, 'N': 4, 'O': 4, 'U': 8, 'V': 4, 'W': 4, 'X': 4}"
INV-ZZ-0001035,SCH-ZZ-0000055,1055,Boeing 787,08/24/2024,08/24/2024,DEL,LAX,270,289,209,-61,80,27,54,81,108,28,12,16,57,42,15,82,72,10,122,83,39,"{'F': 16, 'P': 11}","{'C': 22, 'J': 16, 'Z': 16}","{'Q': 24, 'R': 16, 'S': 8, 'T': 8, 'H': 16, 'M': 8}","{'Y': 8, 'A': 8, 'B': 4, 'D': 4, 'E': 4, 'G': 8, 'I': 4, 'K': 8, 'L': 4, 'N': 4, 'O': 4, 'U': 8, 'V': 4, 'W': 4, 'X': 4}"
INV-ZZ-0001099,SCH-ZZ-0000119,1055,Boeing 787,08/24/2024,08/24/2024,DEL,LAX,270,295,215,-55,80,27,54,81,108,28,23,5,57,52,5,84,50,34,126,90,36,"{'F': 16, 'P': 11}","{'C': 22, 'J': 16, 'Z': 16}","{'Q': 24, 'R': 16, 'S': 8, 'T': 8, 'H': 16, 'M': 8}","{'Y': 8, 'A': 8, 'B': 4, 'D': 4, 'E': 4, 'G': 8, 'I': 4, 'K': 8, 'L': 4, 'N': 4, 'O': 4, 'U': 8, 'V': 4, 'W': 4, 'X': 4}"
INV-ZZ-0001163,SCH-ZZ-0000183,1055,Boeing 787,08/24/2024,08/24/2024,DEL,LAX,270,288,168,-102,120,27,54,81,108,32,16,16,56,20,36,86,54,32,114,78,36,"{'F': 16, 'P': 11}","{'C': 22, 'J': 16, 'Z': 16}","{'Q': 24, 'R': 16, 'S': 8, 'T': 8, 'H': 16, 'M': 8}","{'Y': 8, 'A': 8, 'B': 4, 'D': 4, 'E': 4, 'G': 8, 'I': 4, 'K': 8, 'L': 4, 'N': 4, 'O': 4, 'U': 8, 'V': 4, 'W': 4, 'X': 4}"
INV-ZZ-0001036,SCH-ZZ-0000056,1056,Boeing 787,08/24/2024,08/24/2024,LAX,MAA,270,297,188,-82,109,27,54,81,108,32,25,7,59,39,20,86,68,18,120,56,64,"{'F': 16, 'P': 11}","{'C': 22, 'J': 16, 'Z': 16}","{'Q': 24, 'R': 16, 'S': 8, 'T': 8, 'H': 16, 'M': 8}","{'Y': 8, 'A': 8, 'B': 4, 'D': 4, 'E': 4, 'G': 8, 'I': 4, 'K': 8, 'L': 4, 'N': 4, 'O': 4, 'U': 8, 'V': 4, 'W': 4, 'X': 4}"
INV-ZZ-0001100,SCH-ZZ-0000120,1056,Boeing 787,08/24/2024,08/24/2024,LAX,MAA,270,280,165,-105,115,27,54,81,108,29,12,17,60,30,30,82,73,9,109,50,59,"{'F': 16, 'P': 11}","{'C': 22, 'J': 16, 'Z': 16}","{'Q': 24, 'R': 16, 'S': 8, 'T': 8, 'H': 16, 'M': 8}","{'Y': 8, 'A': 8, 'B': 4, 'D': 4, 'E': 4, 'G': 8, 'I': 4, 'K': 8, 'L': 4, 'N': 4, 'O': 4, 'U': 8, 'V': 4, 'W': 4, 'X': 4}"
INV-ZZ-0001164,SCH-ZZ-0000184,1056,Boeing 787,08/24/2024,08/24/2024,LAX,MAA,270,288,132,-138,156,27,54,81,108,30,18,12,58,21,37,84,35,49,116,58,58,"{'F': 16, 'P': 11}","{'C': 22, 'J': 16, 'Z': 16}","{'Q': 24, 'R': 16, 'S': 8, 'T': 8, 'H': 16, 'M': 8}","{'Y': 8, 'A': 8, 'B': 4, 'D': 4, 'E': 4, 'G': 8, 'I': 4, 'K': 8, 'L': 4, 'N': 4, 'O': 4, 'U': 8, 'V': 4, 'W': 4, 'X': 4}"
INV-ZZ-0001037,SCH-ZZ-0000057,1057,Boeing 787,08/24/2024,08/24/2024,LAX,BLR,270,290,231,-39,59,27,54,81,108,28,24,4,59,36,23,82,68,14,121,103,18,"{'F': 16, 'P': 11}","{'C': 22, 'J': 16, 'Z': 16}","{'Q': 24, 'R': 16, 'S': 8, 'T': 8, 'H': 16, 'M': 8}","{'Y': 8, 'A': 8, 'B': 4, 'D': 4, 'E': 4, 'G': 8, 'I': 4, 'K': 8, 'L': 4, 'N': 4, 'O': 4, 'U': 8, 'V': 4, 'W': 4, 'X': 4}"
INV-ZZ-0001101,SCH-ZZ-0000121,1057,Boeing 787,08/24/2024,08/24/2024,LAX,BLR,270,290,197,-73,93,27,54,81,108,31,21,10,58,38,20,86,65,21,115,73,42,"{'F': 16, 'P': 11}","{'C': 22, 'J': 16, 'Z': 16}","{'Q': 24, 'R': 16, 'S': 8, 'T': 8, 'H': 16, 'M': 8}","{'Y': 8, 'A': 8, 'B': 4, 'D': 4, 'E': 4, 'G': 8, 'I': 4, 'K': 8, 'L': 4, 'N': 4, 'O': 4, 'U': 8, 'V': 4, 'W': 4, 'X': 4}"
INV-ZZ-0001165,SCH-ZZ-0000185,1057,Boeing 787,08/24/2024,08/24/2024,LAX,BLR,270,286,176,-94,110,27,54,81,108,32,19,13,57,30,27,86,78,8,111,49,62,"{'F': 16, 'P': 11}","{'C': 22, 'J': 16, 'Z': 16}","{'Q': 24, 'R': 16, 'S': 8, 'T': 8, 'H': 16, 'M': 8}","{'Y': 8, 'A': 8, 'B': 4, 'D': 4, 'E': 4, 'G': 8, 'I': 4, 'K': 8, 'L': 4, 'N': 4, 'O': 4, 'U': 8, 'V': 4, 'W': 4, 'X': 4}"
INV-ZZ-0001038,SCH-ZZ-0000058,1058,Boeing 787,08/24/2024,08/24/2024,LAX,BOM,270,299,184,-86,115,27,54,81,108,30,19,11,60,52,8,86,69,17,123,44,79,"{'F': 16, 'P': 11}","{'C': 22, 'J': 16, 'Z': 16}","{'Q': 24, 'R': 16, 'S': 8, 'T': 8, 'H': 16, 'M': 8}","{'Y': 8, 'A': 8, 'B': 4, 'D': 4, 'E': 4, 'G': 8, 'I': 4, 'K': 8, 'L': 4, 'N': 4, 'O': 4, 'U': 8, 'V': 4, 'W': 4, 'X': 4}"
INV-ZZ-0001102,SCH-ZZ-0000122,1058,Boeing 787,08/24/2024,08/24/2024,LAX,BOM,270,282,154,-116,128,27,54,81,108,28,15,13,56,36,20,89,35,54,109,68,41,"{'F': 16, 'P': 11}","{'C': 22, 'J': 16, 'Z': 16}","{'Q': 24, 'R': 16, 'S': 8, 'T': 8, 'H': 16, 'M': 8}","{'Y': 8, 'A': 8, 'B': 4, 'D': 4, 'E': 4, 'G': 8, 'I': 4, 'K': 8, 'L': 4, 'N': 4, 'O': 4, 'U': 8, 'V': 4, 'W': 4, 'X': 4}"
INV-ZZ-0001166,SCH-ZZ-0000186,1058,Boeing 787,08/24/2024,08/24/2024,LAX,BOM,270,290,194,-76,96,27,54,81,108,30,20,10,57,36,21,85,44,41,118,94,24,"{'F': 16, 'P': 11}","{'C': 22, 'J': 16, 'Z': 16}","{'Q': 24, 'R': 16, 'S': 8, 'T': 8, 'H': 16, 'M': 8}","{'Y': 8, 'A': 8, 'B': 4, 'D': 4, 'E': 4, 'G': 8, 'I': 4, 'K': 8, 'L': 4, 'N': 4, 'O': 4, 'U': 8, 'V': 4, 'W': 4, 'X': 4}"
INV-ZZ-0001039,SCH-ZZ-0000059,1059,Boeing 787,08/24/2024,08/24/2024,LAX,DUB,270,294,235,-35,59,27,54,81,108,30,11,19,55,46,9,90,73,17,119,105,14,"{'F': 16, 'P': 11}","{'C': 22, 'J': 16, 'Z': 16}","{'Q': 24, 'R': 16, 'S': 8, 'T': 8, 'H': 16, 'M': 8}","{'Y': 8, 'A': 8, 'B': 4, 'D': 4, 'E': 4, 'G': 8, 'I': 4, 'K': 8, 'L': 4, 'N': 4, 'O': 4, 'U': 8, 'V': 4, 'W': 4, 'X': 4}"
INV-ZZ-0001103,SCH-ZZ-0000123,1059,Boeing 787,08/24/2024,08/24/2024,LAX,DUB,270,281,195,-75,86,27,54,81,108,28,26,2,55,50,5,86,68,18,112,51,61,"{'F': 16, 'P': 11}","{'C': 22, 'J': 16, 'Z': 16}","{'Q': 24, 'R': 16, 'S': 8, 'T': 8, 'H': 16, 'M': 8}","{'Y': 8, 'A': 8, 'B': 4, 'D': 4, 'E': 4, 'G': 8, 'I': 4, 'K': 8, 'L': 4, 'N': 4, 'O': 4, 'U': 8, 'V': 4, 'W': 4, 'X': 4}"
INV-ZZ-0001167,SCH-ZZ-0000187,1059,Boeing 787,08/24/2024,08/24/2024,LAX,DUB,270,289,194,-76,95,27,54,81,108,28,18,10,61,49,12,84,60,24,116,67,49,"{'F': 16, 'P': 11}","{'C': 22, 'J': 16, 'Z': 16}","{'Q': 24, 'R': 16, 'S': 8, 'T': 8, 'H': 16, 'M': 8}","{'Y': 8, 'A': 8, 'B': 4, 'D': 4, 'E': 4, 'G': 8, 'I': 4, 'K': 8, 'L': 4, 'N': 4, 'O': 4, 'U': 8, 'V': 4, 'W': 4, 'X': 4}"
INV-ZZ-0001040,SCH-ZZ-0000060,1060,Boeing 787,08/24/2024,08/24/2024,LAX,VNS,270,305,229,-41,76,27,54,81,108,32,26,6,56,41,15,90,72,18,127,90,37,"{'F': 16, 'P': 11}","{'C': 22, 'J': 16, 'Z': 16}","{'Q': 24, 'R': 16, 'S': 8, 'T': 8, 'H': 16, 'M': 8}","{'Y': 8, 'A': 8, 'B': 4, 'D': 4, 'E': 4, 'G': 8, 'I': 4, 'K': 8, 'L': 4, 'N': 4, 'O': 4, 'U': 8, 'V': 4, 'W': 4, 'X': 4}"
INV-ZZ-0001104,SCH-ZZ-0000124,1060,Boeing 787,08/24/2024,08/24/2024,LAX,VNS,270,299,235,-35,64,27,54,81,108,28,18,10,58,54,4,88,63,25,125,100,25,"{'F': 16, 'P': 11}","{'C': 22, 'J': 16, 'Z': 16}","{'Q': 24, 'R': 16, 'S': 8, 'T': 8, 'H': 16, 'M': 8}","{'Y': 8, 'A': 8, 'B': 4, 'D': 4, 'E': 4, 'G': 8, 'I': 4, 'K': 8, 'L': 4, 'N': 4, 'O': 4, 'U': 8, 'V': 4, 'W': 4, 'X': 4}"
INV-ZZ-0001168,SCH-ZZ-0000188,1060,Boeing 787,08/24/2024,08/24/2024,LAX,VNS,270,292,163,-107,129,27,54,81,108,30,24,6,58,35,23,88,56,32,116,48,68,"{'F': 16, 'P': 11}","{'C': 22, 'J': 16, 'Z': 16}","{'Q': 24, 'R': 16, 'S': 8, 'T': 8, 'H': 16, 'M': 8}","{'Y': 8, 'A': 8, 'B': 4, 'D': 4, 'E': 4, 'G': 8, 'I': 4, 'K': 8, 'L': 4, 'N': 4, 'O': 4, 'U': 8, 'V': 4, 'W': 4, 'X': 4}"
INV-ZZ-0001041,SCH-ZZ-0000061,1061,Boeing 787,08/24/2024,08/24/2024,LAX,JFK,270,293,175,-95,118,27,54,81,108,32,22,10,56,27,29,84,78,6,121,48,73,"{'F': 16, 'P': 11}","{'C': 22, 'J': 16, 'Z': 16}","{'Q': 24, 'R': 16, 'S': 8, 'T': 8, 'H': 16, 'M': 8}","{'Y': 8, 'A': 8, 'B': 4, 'D': 4, 'E': 4, 'G': 8, 'I': 4, 'K': 8, 'L': 4, 'N': 4, 'O': 4, 'U': 8, 'V': 4, 'W': 4, 'X': 4}"
INV-ZZ-0001105,SCH-ZZ-0000125,1061,Boeing 787,08/24/2024,08/24/2024,LAX,JFK,270,286,187,-83,99,27,54,81,108,28,25,3,60,32,28,89,64,25,109,66,43,"{'F': 16, 'P': 11}","{'C': 22, 'J': 16, 'Z': 16}","{'Q': 24, 'R': 16, 'S': 8, 'T': 8, 'H': 16, 'M': 8}","{'Y': 8, 'A': 8, 'B': 4, 'D': 4, 'E': 4, 'G': 8, 'I': 4, 'K': 8, 'L': 4, 'N': 4, 'O': 4, 'U': 8, 'V': 4, 'W': 4, 'X': 4}"
INV-ZZ-0001169,SCH-ZZ-0000189,1061,Boeing 787,08/24/2024,08/24/2024,LAX,JFK,270,296,155,-115,141,27,54,81,108,32,24,8,57,47,10,87,36,51,120,48,72,"{'F': 16, 'P': 11}","{'C': 22, 'J': 16, 'Z': 16}","{'Q': 24, 'R': 16, 'S': 8, 'T': 8, 'H': 16, 'M': 8}","{'Y': 8, 'A': 8, 'B': 4, 'D': 4, 'E': 4, 'G': 8, 'I': 4, 'K': 8, 'L': 4, 'N': 4, 'O': 4, 'U': 8, 'V': 4, 'W': 4, 'X': 4}"
INV-ZZ-0001042,SCH-ZZ-0000062,1062,Boeing 787,08/24/2024,08/24/2024,LAX,DEL,270,277,228,-42,49,27,54,81,108,29,21,8,57,47,10,82,65,17,109,95,14,"{'F': 16, 'P': 11}","{'C': 22, 'J': 16, 'Z': 16}","{'Q': 24, 'R': 16, 'S': 8, 'T': 8, 'H': 16, 'M': 8}","{'Y': 8, 'A': 8, 'B': 4, 'D': 4, 'E': 4, 'G': 8, 'I': 4, 'K': 8, 'L': 4, 'N': 4, 'O': 4, 'U': 8, 'V': 4, 'W': 4, 'X': 4}"
INV-ZZ-0001106,SCH-ZZ-0000126,1062,Boeing 787,08/24/2024,08/24/2024,LAX,DEL,270,294,199,-71,95,27,54,81,108,30,21,9,60,20,40,82,58,24,122,100,22,"{'F': 16, 'P': 11}","{'C': 22, 'J': 16, 'Z': 16}","{'Q': 24, 'R': 16, 'S': 8, 'T': 8, 'H': 16, 'M': 8}","{'Y': 8, 'A': 8, 'B': 4, 'D': 4, 'E': 4, 'G': 8, 'I': 4, 'K': 8, 'L': 4, 'N': 4, 'O': 4, 'U': 8, 'V': 4, 'W': 4, 'X': 4}"
INV-ZZ-0001170,SCH-ZZ-0000190,1062,Boeing 787,08/24/2024,08/24/2024,LAX,DEL,270,295,178,-92,117,27,54,81,108,32,14,18,60,47,13,91,36,55,112,81,31,"{'F': 16, 'P': 11}","{'C': 22, 'J': 16, 'Z': 16}","{'Q': 24, 'R': 16, 'S': 8, 'T': 8, 'H': 16, 'M': 8}","{'Y': 8, 'A': 8, 'B': 4, 'D': 4, 'E': 4, 'G': 8, 'I': 4, 'K': 8, 'L': 4, 'N': 4, 'O': 4, 'U': 8, 'V': 4, 'W': 4, 'X': 4}"